A. ZARATE GENERAL HOSPITAL	----->Pulanglupa, Las Piñas City
AFP MEDICAL CENTER	----->V. Luna Road, Quezon City
ABATAN EMERGENCY	----->HOSPITAL Abatan, Buguias, Benguet
ABELLA MIDWAY HOSPITAL	----->Valencia City, Bukidnon
ABORLAN MEDICARE HOSPITAL	----->Pob. Aborlan, Palawan
ABRA DE ILOG MUNICIPAL	----->HOSPITAL Abra de Ilog, Occidental Mindoro
ABRA PROVINCIAL HOSPITAL	----->Calaba, Bengued, Abra
ABULUG MUNICIPAL HOSPITAL	----->Centro Abulug, Cagayan Valley
ABUYOG DISTRICT HOSPITAL	----->Abuyog, Northern Leyte
ACAS CLINIC AND HOSPITAL	----->Vigan, Ilocos Sur
ACEBEDO GENERAL HOSPITAL	----->Bagbaguin, Caloocan City
ACOSTA CLINIC	----->Toril, Davao City
ADELA SERRA TY MEMORIAL	----->Tandag, Surigao del Sur
ADVENTIST UNIVERSITY	----->Silang,Cavite
AFABLE MEDICAL CENTER	----->EBB, Olongapo City
AGLIPAY DISTRICT HOSPITAL	----->Aglipay, Quirino
AGO GENERAL HOSPITAL	----->Rizal Street, Legaspi City
AGOO FAMILY HOSPITAL	----->San Pedro, Agoo, La Union
AGOO MEDICAL CLINIC	----->Agoo, La Union
AGPALO HOSPITAL	----->GUIUAN POLYMEDIC Guiuan, Eastern Samar
AGUINALDO PEOPLE'S	----->HOSPITAL Aguinaldo, Ifugao
AGUSAN DEL NORTE PROVINCIAL HOSPITAL	----->Libertad, Butuan City
AIR FORCE GENERAL HOSPITAL	----->Pasay City
AKLAN BAPTIST HOSPITAL, INC.	----->Caticlan, Malay, Aklan
AKLAN COOPERATIVE MISSION Hosp	----->Kalibo, Aklan
ALABA EMERGENCY hosp	----->Maco, Compostela Valley
ALABANG MEDICAL CENTER	----->Muntinlupa City
ALABANG MEDICAL CLINIC	----->Alabang, Muntinlupa City
ALABANG MEDICAL CLINIC -MUNTINLUPA BRANCH	----->No. 1 National Rd., Putatan Muntinlupa City
ALABANG MEDICAL CLINIC -	----->Talon, Las Piñas City
ALABAT ISLAND DISTRICT hosp	----->Alabat Island, Quezon
ALAMADA PROVINCIAL	----->Magsaysay, Alamada North Cotabato
ALAMINOS DOCTOR'S	----->Bolaney, Alaminos, Pangasinan
ALBAY DOCTOR'S HOSPITAL	----->Penaranda St., Legaspi City, Albay40
ALBINO DURAN MEMORIAL	----->Balangiga, Eastern Samar
ALBOR DISTRICT HOSPITAL	----->Libjo, Surigao del Norte
ALCALA MUNICIPAL HOSPITAL	----->Alcala, Cagayan Valley
ALEGRE MEDICAL CLINIC	----->Kapalong, Davao del Norte
ALEOSAN DISTRICT HOSPITAL	----->Aleosan, North Cotabato
ALEOSAN DISTRICT HOSPITAL	----->Alimodian, Iloilo City
ALFEROS HOSPITAL	----->Olongapo City
ALFONSO SPECIALISTS HOSPITAL	----->Pasig City
ALFONSO PONCE ENRILE	----->Gonzaga, Cagayan Valley
ALFREDO MARANON SR.	----->Brgy. Bato, Sagay City Negros Occidental
ALICIA DISTRICT HOSPITAL	----->Sibugay, Zamboanga
ALLEN DISTRICT HOSPITAL	----->Allen, Northern Samar
ALMORA GENERAL HOSPITAL	----->Balunao, Tabuk Kalinga, Apayao
ALTAVAS DISTRICT HOSPITAL	----->Altavas, Aklan
ALTERADO GENERAL HOSPITAL	----->R. Castillo St., Agdao Davao City
AMAI PAKPAK MEDICAL	----->CENTER Marawi City, Lanao del Sur
AMANG RODRIGUEZ MEDICAL CENTER	----->Sumulong Highway, Marikina City
AMIO COMMUNITY PRIMARY	----->HOSPITAL Sta. Catalina, Negros Oriental
AMISOLA MATERNITY HOSPITAL	----->1068 Hermosa Street, Tondo Manila
AMMA JADSAC DISTRICT	----->HOSPITAL Pudtol, Kalinga, Apayao
AMOIL CLINIC AND HOSPITAL	----->Brgy. J. C. Montilla, Tacurong Sultan Kudarat
AMOROSO MEDICAL CLINIC	----->Imelda, Zamboanga Sibugay
AMOSUP SEAMEN'S	----->HOSPITAL - CEBU Mandaue City, Cebu
AMOSUP SEAMEN'S	----->HOSPITAL - ILOILO Mandurriao, Iloilo City
ANAHAWAN DISTRICT HOSPITAL	----->Anahawan, Southern Leyte
ANDOT MEDICAL CLINIC	----->Bacolod, Lanao Del Norte
ANDRES SORIANO MEMORIAL	----->HOSPITAL COOPERATIVE Tabon, Bislig, Surigao del Sur
ANGEL SALAZAR MEMORIAL	----->GENERAL HOSPITAL Brgy. Atabay, San Jose Antique
ANGELES MEDICAL CENTER	----->Rizal St., Angeles City
ANGELES UNIVERSITY	----->FOUNDATION MEDICAL CENTER McArthur Hi-way Angeles City
ANGONO GENERAL HOSPITAL	----->Angono, Rizal
ANGONO MEDICS HOSPITAL	----->Angono, Rizal
ANICETO T. PESANTE SR.	----->MEMORIAL HOSPITAL Midsayap, North Cotabato
ANN FRANCIS MATERNITY HOSPITAL	----->606 Quirino Highway Novaliches, Quezon City
ANTEQUERA COMMUNITY	----->HOSPITAL Antequera, Bohol
ANTIPAS MEDICAL SPECIALIST	----->HOSPITAL, INC. (former CLINICA CATOTAL) Antipas, North Cotabato
ANTIPOLO CITY MEDICAL	----->HOSPITAL Sumulong Highway, Antipolo City
ANTIPOLO DISTRICT HOSPITAL	----->Bagong Nayon2, Antipolo City
ANTIPOLO DOCTORS HOSPITAL	----->Antipolo City
ANTONIO D. FLORENDO HOSPITAL	----->Tadeco, Panabo City Davao del Norte
ANULAO ST. M.ICHAEL MEDICAL	----->CLINIC & HOSPITAL Cabacan, North Cotabato
APACIBLE MEMORIAL	----->DISTRICT HOSPITAL Nasugbu, Batangas
APALIT DOCTORS HOSPITAL	----->Apalit, Pampanga
APARRI MEDICARE COMMUNITY	----->HOSPITAL Bangag, Aparri, Cagayan
APARRI PROVINCIAL HOSPITAL	----->Toran Aparri, Cagayan
APAYAO DISTRICT HOSPITAL	----->Calanasan, Mabubua, Apayao
APAYAO PROVINCIAL HOSPITAL	----->(formerly Kabugao District Hosp.) Kabugao, Kalinga, Apayao
AQUINAS UNIVERSITY HOSPITAL	----->Washington Drive, Legaspi City
ARAKAN VALLEY DISTRICT	----->HOSPITAL Arakan, North Cotabato
ARAYAT MEDICAL &	----->OB-GYNE CLINIC Brgy. Mangga, Cacutud Arayat, Pampanga
ARMY STATION HOSPITAL	----->(formerly Camp Capinpin Station Hospital) Brgy. Sampaloc Tanay, Rizal
ARNAIZ HOSPITAL	----->Cainta, Rizal
AROROY MUNICIPAL HOSPITAL	----->Aroroy, Masbate
ARSENAL "KALUSUGAN"	----->HOSPITAL Lamao, Limay, Bataan
ARTECHE DISTRICT HOSPITAL	----->Arteche, Eastern Samar
ARUELO GENERAL HOSPITAL	----->Tangub City, Misamis Occidental
ASANIAS POLYCLINIC	----->Sanchez Mira, Cagayan
ASIA MEDIC FAMILY HOSPITAL	----->AND MEDICAL CLINIC Dasmariñas, Cavite
ASIAH MEDICAL HOSPITAL	----->San Pedro Dist., Pagadian City
ASIAN HOSPITAL AND MEDICAL CENTER	----->MEDICAL CENTER 2205 Civic Drive, Centennial Lane Filinvest Corporate City Alabang, Muntinlupa City
ASILO HOSPITAL	----->Padada, Davao del Sur
ASINGAN MEDICARE &	----->COMMUNITY HOSPITAL Asingan, Pangasinan
ASSCOM - DLSUMC	----->FRIENDSHIP HOSPITAL San Juan, Apalit, Pampanga
ASSUMPTA MEDICAL HOSPITAL	----->Taal, Batangas
ATOK DISTRICT HOSPITAL	----->Sayangan, Atok, Benguet
AUGUIS CLINIC AND HOSPITAL	----->Gen. Santos City
AURORA GENERAL HOSPITAL	----->Aurora, Zamboanga del Sur
AURORA MEMORIAL HOSPITAL	----->Baler, Aurora
AZNAR MEDICAL CLINIC	----->Maramag, Bukidnon
BBCSS PEDIATRIC MEDICAL	----->& SURGICAL CLINIC Cauayan City, Isabela
BABAK COMMUNITY HOSPITAL	----->Babak, Davao del Norte
BABARAN-ECHAVEZ MEDICAL	----->AND PSYCHIATRIC CLINIC 1125 Amparo St., Poblacion Muntinlupa City
BABOL GENERAL HOSPITAL	----->Matalam, North Cotabato
BACNOTAN DISTRICT HOSPITAL	----->Bacnotan, La Union
BACOLOD ADVENTIST	----->MEDICAL CENTER Taculing, Bacolod City
BACOLOD OUR LADY OF MERCY SPECIALIST HOSPITAL	----->MERCY SPECIALTY HOSP. Eureco, Mandalagan Bacolod City, Negros Occidental
BACONAWA HOSPITAL	----->Rizal St., Llorente,Eastern Samar
BADIAN DISTRICT HOSPITAL	----->Badian, Cebu City
BAESA ADVENT POLYCLINIC	----->AND GENERAL HOSPITAL 238 Deparo St., Baesa Caloocan City
BAGAC MEDICARE & COMMUNITY HOSPITAL	----->Brgy. Atilano Ricardo, Bagac Bataan
BAGGAO MEDICARE	----->COMMUNITY HOSPITAL Baggao, Cagayan Valley
BAGGAO MUNICIPAL HOSPITAL	----->Tallang, Baggao, Cagayan
BAGO CITY HOSPITAL	----->Bago City, Negros Occidental
BAGONG CAINTA MUNICIPAL	----->HOSPITAL Sto. Domingo, Cainta Rizal
BAGTILAY ADULT SPECIALTY	----->CLINIC AND HOSPITAL San Isidro, Isabela
BAGUIO FILIPINO CHINESE	----->GENERAL HOSPITAL Trancoville, Baguio City
BAGUIO GENERAL HOSPITAL	----->& MEDICAL CENTER Gov. Park Rd., Baguio City
BAGUIO MEDICAL CENTER	----->9 Military Cut-off Road Baguio City
BAILAN DISTRICT HOSPITAL	----->Bailan, Pontevedra, Capiz
BAIS DISTRICT HOSPITAL	----->Bais City, Negros Oriental
BAKING MEDICAL CENTER	----->Minglanilla, Cebu City
BALAMBAN DISTRICT HOSPITAL	----->Balamban, Cebu
BALIBAGO POLYCLINIC	----->AND HOSPITAL Sta. Rosa, Laguna
BALINDONG DISTRICT	----->HOSPITAL Balindong, Lanao del Sur
BALITUCAN DISTRICT HOSPITAL	----->San Pablo, Magalang, Pampanga
BALIUAG DISTRICT HOSPITAL	----->Sabang Baliuag,Bulacan
BALLESTEROS DISTRICT HOSPITAL	----->Ballesteros, Cagayan Valley
BALLESTEROS MATERNITY	----->AND LYING-IN CLINIC Centro East, Ballesteros Cagayan
BALO-I PROVINCIAL HOSPITAL	----->Balo-I, Lanao Del Norte
BALUD MUNICIPAL HOSPITAL	----->Balud, Masbate
BANEZ HOSPITAL	----->(former BAÑEZ CLINIC) Carmen, Rosales, Pangasinan
BANGUED CHRISTIAN HOSPITAL	----->Torrijos St., Bangued, Abra
BANGUI DISTRICT HOSPITAL	----->Bangui, Ilocos Norte
BANSALAN MEDICAL CLINIC	----->Bansalan, Davao del Sur
BANTAYAN DISTRICT HOSPITAL	----->Bantayan Island, Cebu
BARILI DISTRICT HOSPITAL	----->Barili, Cebu
BARLIG DISTRICT HOSPITAL	----->Barlig, Mt. Province
BARON-YEE HOSPITAL	----->Padada, Davao Del Sur
BAROTAC VIEJO DSTRICT	----->HOSPITAL Barotac Viejo, Iloilo
BASA AIR BASE HOSPITAL	----->Floridablanca, Pampanga
BASEY DISTRICT HOSPITAL	----->Basey, Western Samar
BASILAN COMMUNITY	----->HOSPITAL, INC Isabela City, Basilan
BASILAN GEN. HOSPITAL	----->Basilan, Isabela
BATAAN DOCTOR'S HOSPITAL	----->Dona Francisca Subd. Balanga City, Bataan
BATAAN GENERAL HOSPITAL	----->Balanga, Tenejero Bataan Tenejero, Balanga
BATAAN PENINSULA	----->MEDICAL CENTER Dinalupihan, Bataan
BATAAN ST. JOSEPH HOSPITAL	----->Don Manuel Banzon St. Balanga, Bataan
BATAAN WOMEN'S HOSPITAL INC.	----->St. Joseph Subd., Balanga City
BATANES GENERAL HOSPITAL	----->Basco, Batanes
BATANGAS HEALTHCARE HOSPITAL	----->(former Jesus Nazarene Medical Center) Brgy. Gulod Itaas, Batangas City
BATANGAS REGIONAL HOSPITAL	----->Batangas City
BATO MATERNITY AND	----->CHILDREN'S HOSPITAL Bato, Catanduanes
BAUAN DOCTORS GEN. HOSPITAL	----->Bauan, Batangas
BAUAN GENERAL HOSPITAL	----->Bauan, Batangas
BAUTISTA HOSPITAL	----->Caridad, Cavite City
BAYAMBANG DISTRICT HOSPITAL	----->Bayambang, Pangasinan
BAYAWAN DISTRICT HOSPITAL	----->Bayawan, Negros Oriental
BAYUGAN COMMUNITY HOSPITAL	----->Bayugan, Agusan del Sur
BAYUGAN J.M. YAP STO. NIÑO	----->HOSPITAL Rotunda, Bayugan Agusan del Sur
BEATO CAUILAN HOSPITAL	----->Villa Carolina I, National Highway Tunasan, Muntinlupa City
BENDIJO HOSPITAL (former St. Anthony	----->General Hospital) Hagonoy, Davao del Sur
BENGUET GENERAL HOSPITAL	----->Km. 5, La Trinidad, Benguet
BERACHAH MEDICAL CLINIC	----->Nat'l. Hi-way, Brooke's Point Palawan
BERMUNDEZ POLYMEDIC HOSPITAL	----->Tala, Kalookan City
BERNARDINO GENERAL HOSPITAL I	----->680 Quirino Highway, Sn. Bartolome, Novaliches Quezon City
BERNARDINO GENERAL HOSPITAL II	----->North Olympus Subd. Quezon City
BESSANG PASS MEMORIAL	----->HOSPITAL Cervantes, Ilocos Sur
BESSAO DISTRICT HOSPITAL	----->Bessao, Mt. Province
BETHANY HOSPITAL	----->Real St., Tacloban City
BETHANY HOSPITAL, INC.	----->San Fernando City, La Union
BETHEL BAPTIST HOSPITAL, INC.	----->Sumpang, Malaybalay Malaybalay City
BICOL MEDICAL CENTER	----->Concepcion Pequeña Sr. Naga City, Camarines Sur
BICOL REGIONAL TRAINING	----->AND TEACHING HOSPITAL Rizal St., Legaspi City, Albay
BICOL SANITARIUM	----->Cabusao, Camarines Sur
BILIRAN PROVINCIAL HOSPITAL	----->Naval, Biliran
BINALBAGAN INFIRMARY	----->Rizal, Binalbagan Negros Occidental
BIÑAN DOCTOR'S HOSPITAL, INC.	----->Platero, Biñan, Laguna
BINDOY DISTRICT HOSPITAL	----->Bindoy, Negros Oriental
BIRHEN SA REGLA MEDICAL	----->CLINIC Tulunan, North Cotabato
BIRI DISTRICT HOSPITAL	----->Biri, Northern Samar
BISHOP JOSEPH REAGAN	----->MEMORIAL HOSPITAL Christ the King, Tagum City
BISLIG DISTRICT HOSPITAL	----->Bislig, Surigao del Sur
BLANCIA HOSPITAL	----->Molave, Zamboanga del Sur
BLESSED FAMILY DOCTORS	----->GENERAL HOSPITAL San Carlos City, Pangasinan
BLESSED TRINITY MATERNITY	----->& MEDICAL HOSPITAL Unit I Bufer Bldg. Avatec Road Marcos Highway, Mayamot Antipolo City
BOGO MEDELLIN MEDICAL CENTER	----->Medellin, Cebu
BOHOL SAINT JOSEPH CLINIC	----->Tubigon, Bohol
BOHOL ST. JOHN	----->COMMUNITY HOSPITAL Nar. Hi-way, Canaya-on Garcia Hernandez, Bohol
BOHOL ST. JUDE HOSPITAL	----->Tagbilaran City
BOISER MEDICAL CLINIC	----->Sto. Tomas, Daval del Norte
BOLINAO MEDICARE	----->COMMUNITY HOSPITAL Bolinao, Pangasinan
BONDOC PENINSULA	----->DISTRICT HOSPITAL Catanauan,Quezon
BONGABON DISTRICT HOSPITAL	----->Curva, Bongabon, Nueva Ecija
BONGABONG COMMUNITY	----->HOSPITAL Bongabong, Oriental Mindoro
BONGAO DOCTOR'S HOSPITAL	----->(formerly Tawi-Tawi Doctor's Hospital) Brgy. Mampallan, Bongao, Tawi-Tawi12
BONGCAS HOLY CHILD	----->HOSPITAL Poblacion, Maramag, Bukidnon
BONIFACIO MEDICAL CLINIC	----->Bonifacio, Misamis Occidental
BONTILAO'S COUNTRY CLINIC	----->Maranding, Lala, Lanao Del Norte
BONTOC GENERAL HOSPITAL	----->Bontoc, Mt. Province
BONTUYAN MEDICAL CLINIC	----->Polomolok, South Cotabato
BORBON GENERAL HOSPITAL	----->Pagadian City, Zamboanga del Sur 15
BORJA FAMILY HOSPITAL	----->CORPORATION Tagbilaran City
BORONGAN DOCTORS'	----->HOSPITAL Borongan, Eastern Samar
BRENT HOSPITAL & COLLEGES, INC.	----->R.T. Lim Blvd., Zamboanga City
BRIGADIER GEN. BENITO EBUEN	----->AIR BASE HOSPITAL Lapu-Lapu City
BROKENSHIRE INTEGRATED	----->HEALTH MINISTRIES, INC. Madapo Hills, Davao City
BUCAG'S HOSPITAL	----->Cauayan City, Isabela
BUCAY MUNICIPAL HOSPITAL	----->Siblong, Bucay, Abra
BUDA COMMUNITY HEALTH CARE CENTER	----->Marilog Dist. Davao City
BUENAVISTA EMERGENCY HOSPITAL	----->Mac Lain, Buenavista, Guimaras
BUGALLON GENERAL HOSPITAL	----->AND DIABETES CENTER Bugallon, Pangasinan
BUGASONG MEDICARE	----->COMMUNITY HOSPITAL Bugasong, Antique
BUKIDNON COMMUNITY	----->HEALTH CARE CENTER Fortich St., Purok 15 Valencia City, Bukidnon
BUKIDNON PROVINCIAL	----->HOSPITAL - KIBAWE Kibawe, Bukidnon
BUKIDNON PROVINCIAL	----->HOSPITAL - KALILANGAN West Pob., Kalilangan, Bukidnon
BUKIDNON PROVINCIAL	----->HOSPITAL - MALITBOG Malitbog, Bukidnon
BUKIDNON PROVINCIAL HOSP.-	----->MANOLO FORTICH Manolo Fortich, Bukidnon
BUKIDNON PROVINCIAL HOSPITAL-	----->MARAMAG BUKIDNON North Poblacion, Maramag Bukidnon
BUKIDNON PROVINCIAL HOSP.	----->(IPHO) of MALAYBALAY CITY Malaybalay City, Bukidnon
BUKIDNON PROVINCIAL HOSP.-	----->SAN FERNANDO San Fernando, Bukidnon
BUKIDNON PROVINCIAL HOSPITAL-	----->TALAKAG Talakag, Bukidnon
BULACAN MATERNITY &	----->CHILDREN HOSPITAL (formerly Calumpit District Hospital) Canlogan, Calumpit, Bulacan
BULACAN MEDICAL CENTER	----->Majon, Malolos, Bulacan
BULACAN MEDICAL MISSION	----->GROUP PHARMACY & HOSPITAL - TURO BRANCH Bocaue, Bulacan
BULACAN POLYMEDIC HOSPITAL	-----># 113 Cagayan Valley Road Sta Cruz, Guiguinto, Bulacan
BULALACAO COMMUNITY HOSPITAL	----->Bulalacao, Oriental Mindoro
BULAN MUNICIPAL HOSPITAL	----->Mojon, Bulan, Sorsogon
BULLECER MEDICAL CLINIC	----->Toril, Davao City
BULUAN DISTRICT HOSPITAL	----->Buluan, Maguindanao
BULUSAN FAMILY CLINIC	----->Bulusan, Sorsogon
BUNAWAN DISTRICT HOSPITAL	----->Bunawan, Agusan del Sur
BUNGABONG-SANICO	----->MEDICAL HOSPITAL Sto. Tomas, Davao del Norte
BURAUEN DISTRICT HOSPITAL	----->Burauen, NorthernLeyte
BURUANGA MUNICIPAL HOSPITAL	----->Buruanga, Aklan
BUSTOS COMMUNITY HOSPITAL	----->Bustos, Bulacan
BUTUAN DOCTORS' HOSPITAL, INC.	----->J. C. Aquino Ave.,Butuan City
BUTUAN MEDICAL CENTER	----->Km 5 Baan, Butuan City
BUTUAN PUERICULTURE CENTER	----->No. 394 INC ELISA R.OCHOA MEMORIAL MATERNITY & GEN. HOSPITAL 702 San Jose St., Butuan City
C & H MEDICAL AND SURGICAL CLINIC	----->Alaminos City, Pangasinan
C.M. RECTO MEMORIAL	----->DISTRICT HOSPITAL Rizal St., Infanta, Quezon
C.P. REYES HOSPITAL	----->Tanauan, Batangas
CABA MEDICARE 	----->COMMUNITY HOSPITAL Caba, La Union
CABADBARAN DISTRICT HOSP.	----->Cabadbaran, Agusan del Norte
CABANGAN INFIRMARY	----->Dolores, Cabangan Zambales
CABATUAN FAMILY CLINIC	----->AND HOSPITAL Cabatuan, Isabella
CABIAO GENERAL HOSPITAL, INC.	----->San Fernando Sur, Cabiao Nueva Ecija
CABINTE MATERNITY AND	----->CHILDREN'S' HOSPITAL Talon 5, Las Pinas City
CABREDO GENERAL HOSPITAL	----->Tabaco City, Albay
CADIZ DISTRICT HOSPITAL	----->Hortencia, Cadiz City, Negros Occidental
CADULONG MEDICAL CLINIC	----->Roxas, North Cotabato
CAGAYAN DE ORO MATERNITY	----->CHILDREN'S HOSPITAL AND PUERICULTURE CENTER Tiano Justo Gaerlan Street Cagayan De Oro City
CAGAYAN DE ORO MEDICAL CENTER, INC.	----->Tiano-Nacalaban St. Cagayan de Oro City
CAGAYAN DE ORO POLYMEDIC	----->GENERAL HOSPITAL Don Apolinario Velez St. Cagayan de Oro City
CAGAYAN DE ORO POLYMEDIC	----->MEDICAL PLAZA Kauswagan, Cagayan De Oro City
CAGAYAN DE TAWI-TAWI	----->DISTRICT HOSPITAL Brgy. Lupa Lupa Mapun,Tawi-Tawi
CAGAYAN VALLEY MEDICAL CENTER	----->Carig, Tuguegarao, Cagayan
CAGAYAN VALLEY ADVENTIST	----->HOSPITAL INC. Santiago City, Isabela
CAGRARAY DISTRICT HOSPITAL	----->Cabasan, Bacacay, Albay
CAINGLET MEDICAL CLINIC	----->Panabo, Davao del Norte
CALALANG GENERAL HOSPITAL	----->16R Valenzuela St., McArthur H-way, Marulas,Valenzuela City
CALAMBA DISTRICT HOSPITAL	----->Calamba, Misamis Occidental
CALAMBA DOCTOR'S HOSPITAL	----->Parian, Calamba City, Laguna
CALAMBA MEDICAL CENTER	----->Calamba City, Laguna
CALATAGAN MEDICARE HOSPITAL	----->Calatagan, Batangas
CALATRAVA DISTRICT HOSPITAL	----->Calatrava, Negros Occidental
CALBAYOG DISTRICT HOSPITAL	----->Calbayog City, Western Samar
CALBAYOG SANITARIUM AND HOSPITAL	----->Calbayog City, Western Samar
CALLANG GENERAL HOSPITAL	----->Santiago City, Isabela
CALLEJO MEDICAL CLINIC	----->545-A Talon Garden Las Piñas City
CAMARINES NORTE	----->PROVINCIAL HOSPITAL Daet, Camarines Norte
CAMIGUIN GENERAL HOSPITAL	----->Mambajao, Camiguin
CAMP AQUINO STATION HOSPITAL	----->Camp Aquino, Northern Luzon Command, San Miguel, Tarlac
CAMP BRIG.GEN. SALIPADA	----->K. PENDATUN HOSPITAL Camp. BGSKP, Parang, Maguindanao
CAMP EVANGELISTA STATION	----->HOSPITAL 4th ID PA Patag, Cagayan de Oro City
CAMP GENERAL ARTEMIO	----->RICARTE STATION HOSPITAL Pto. Princesa City, Palawan
CAMP GEN. EMILIO AGUINALDO	----->STATION HOSPITAL Camp. Gen. E. Aguinaldo Murphy, Cubao, Quezon City
CAMP LAPU-LAPU ARMY	----->STATION HOSPITAL Lahug, Cebu
CAMP LUKBAN STATION HOSPITAL	----->Catbalogan, Samar
CAMP MELCHOR F. DELA CRUZ	----->STATION HOSPITAL Camp MPI, Gamu, Isabela
CAMP NAKAR STATION HOSPITAL	----->Camp Guillermo Nakar Lucena City, Quezon
CAMP NAVARRO GEN. HOSPITAL	----->Upper Calarian, Zamboanga City
CAMP PANACAN STATION	----->HOSPITAL SOUTHERN AFP Camp Panacan, Davao City
CAMP PERALTA STATION HOSPITAL	----->Camp Peralta, Jr., 3rd Infanty (Spearhead) Div. PA, Jamindan, Capiz
CAMP SIONGCO STATION HOSPITAL	----->CP B. Gen. Gonzalo H. Siongco, Awang, Maguindanao
CAN - AVID MUNICIPAL HOSPITAL	----->Can-Avid, Eastern Samar
CANDELARIA DISTRICT	----->HOSPITAL Yamat, Candelaria, Zambales
CANDELARIA MUNICIPAL	----->HOSPITAL Candelaria, Quezon
CANDIJAY MEDICARE	----->COMMUNITY HOSPITAL Candijay, Bohol
CANDON GENERAL HOSPITAL	----->Candon, Ilocos Sur
CANLAON DISTRICT HOSPITAL	----->Canlaon City, Negros Oriental
CAPAZ MULTI-SPECIALTY HOSP.	----->M.H. Del Plar St., Sto. Rosario Capaz, Tarlac
CAPITOL MEDICAL CENTER	----->17 Panay Avenue, Quezon City
CAPITOL UNIVERSITY MEDICAL	----->FOUNDATION, INC. Gusa Highway, Cagayan De Oro City
CAPIZ DOCTOR'S HOSPITAL	----->Fuentes Drive, Roxas City
CAPIZ EMMANUEL HOSP., INC.	----->Roxas Avenue, Roxas City
CAPT. RUPERTO LUZON	----->MEMORIAL HOSPITAL Duero, Bohol
CAPUL DISTRICT HOSPITAL	----->Capul, Northern Samar
CARAGA HOSPITAL INFANT	----->CARE LYING IN CENTER J.C. Avenue, Libertad Butuan City
CARAGA REGIONAL HOSPITAL	----->Rizal St., Surigao del Norte
CARAMOAN MUNICIPAL	----->HOSPITAL Tawag, Caramoan, Camarines Sur
CARAMORAN MUNICIPAL	----->HOSPITAL Datag, Caramoran, Catanduanes
CARDINAL SANTOS MEDICAL CENTER	----->Wilson St., Greenhills, San Juan
CARIGARA DISTRICT HOSPITAL	----->Carigara, Northern Leyte
CARLITO O. ALVIZO AND	----->CHILDREN'S CLINIC Cantilan, Surigao Del Sur
CARLOS MEDICAL AND	----->MATERNITY CLINIC Cardona, Rizal
CARMEN COPPER CORP. HOSPITAL	----->Don Andres Soriano, Toledo City
CARMEN DISTRICT HOSPITAL	----->Carmen, Davao del Norte
CARMEN MEDICAL CLINIC &	----->HOSPITAL Carmen, Davao del Norte
CARMELITE HOSPITAL	----->Nat'l. Highway, Panabo City Davao del Norte
CARRANGLAN MEDICARE &	----->COMMUNITY HOSPITAL Carranglan, Nueva Ecija
CASAUL GENERAL HOSPITAL, INC.	----->16 Tandang Sora Ave. Novaliches, Quezon City
CASIGURAN DISTRICT HOSPITAL	----->Brgy. Marikit, Casiguran, Aurora
CASTRO MATERNITY & GENERAL	----->HOSPITAL (former CASTRO MATERNITY HOSPITAL) Baliuag, Bulacan
CATAINGAN DISTRICT HOSPITAL	----->Cataingan, Masbate
CATALAN MEDICAL HOSPITAL	----->Carmona, Cavite
CATARMAN DISTRICT HOSPITAL	----->Catarman, Camiguin
CATEEL DISTRICT HOSPITAL	----->Cateel, Davao Oriental
CATIGBIAN DISTRICT HOSPITAL	----->Catigbian, Bohol
CATUBIG DISTRICT HOSPITAL	----->Catubig, Northern Samar
CAUAYAN DISTRICT HOSPITAL	----->Cauayan City, Isabela
CAUAYAN FAMILY HOSPITAL	----->Prenza, Cauayan City, Isabela
CAUAYAN MEDICAL SPECIALIST	----->HOSPITAL Cauayan City, Isabela
CAUAYAN MUNICIPAL HOSPITAL	----->Cauyan, Negros Occidental
CAVITE MEDICAL CENTER	----->Cavite Blvd., Dalahican, Cavite
CAVITE MUNICIPAL HOSPITAL	----->Maragondon, Cavite
CAVITE NAVAL HOSPITAL	----->Cavite City
CAWAYAN MUNICIPAL HOSPITAL	----->Cawayan, Masbate
CEBU CITY MEDICAL CENTER	----->Natalio, Bacalso Avenue, Cebu City
CEBU DOCTORS' HOSPITAL	----->Osmeña Blvd., Cebu City
CEBU NORTH GENERAL HOSPITAL	----->Talamban, Cebu City
CEBU PUERICULTURE CENTER	----->& MATERNITY HOSPITAL B. Rodriguez, Cebu City
CEBU SOUTH GENERAL HOSPITAL	----->National Road, Tuyan,Naga, Cebu 50
CEBU VELEZ GEN. HOSPITAL, INC.	----->F. Ramos, Cebu City
CEFERINO L. JIMENEZ CHILD CLINIC	----->San Fernando City, Pampanga
CENTENO MEDICAL SPECIALISTS	----->HOSPITAL INC. Bansalan, Davao Del Sur
CENTRAL AZUCARRERA	----->DON PEDRO HOSPITAL Nasugbu, Batangas
CENTRAL ILOCOS SUR DISTRICT	----->HOSPITAL Narvacan, Ilocos Sur
CENTRAL LUZON DOCTORS	----->HOSPITAL San Vicente, Tarlac City
CENTRAL LUZON STATE	----->UNIVERSITY HOSPITAL Muñoz, Nueva Ecija
CENTRAL MINDANAO	----->UNIVERSITY HOSPITAL Musuan, Maramag, Bukidnon
CEREVILLE MEDICAL CLINIC	----->Sta. Cruz, Davao del Sur
CHARLES W. SELBY MEMORIAL	----->HOSPITAL, INC. Aparri, Cagayan
CHAVEZ MEDICAL CLINIC	----->Pob. Dinas, Zamboanga del Sur
CHILDREN'S MEDICAL HOSPITAL	----->Calapan City, Oriental Mindoro
CHINESE GENERAL HOSPITAL	----->AND MEDICAL CENTER 286 Blumentritt St. Sta Cruz, Manila
CHONG HUA HOSPITAL	----->Fuente, Osmeña Street,Cebu
CHRISTIAN GENERAL HOSPITAL	----->Pagsanjan, Laguna
CHRIST THE KING	----->GENERAL HOSPITAL 130 Real St., Pamplona Las Piñas City
CICOSAT HOSPITAL	----->Lingsat, San Fernando City La Union
CITY OF CANDON HOSPITAL	----->Nat'l. Hi-way, San Nicolas Candon City, Ilocos Sur
CIUDAD MEDICAL ZAMBOANGA	----->Nunez Ext., Zamboanga City
CLARIN COMMUNITY HOSPITAL	----->Clarin, Bohol
CLARK AIRBASE HOSPITAL	----->Clark Field, Pampanga
CLARK CENTRAL MEDICAL CENTER	----->Anunas, Angeles City, Pampanga
CLAVERIA DISTRICT HOSPITAL	----->Claveria, Masbate
CLINICA ARELLANO	----->GENERAL HOSPITAL 1430 D. Jose, Sta. Cruz, Manila
CLINICA DE LEON	----->Bonifacio Street,Tuguegarao City
CLINICA FELICIANO II	----->Magsaygay Ave., Calinan Davao City
CLINICA GATCHALIAN AND HOSPITAL	----->Ormoc City
CLINICA HENSON	----->Angeles City
CLINICA ISAGUIRRE	----->Calinan, Davao City
CLINICA JESUS NAZARENO	----->Magallanes, Agusan Del Norte
CLINICA LUNTAO AND HOSPITAL	----->Norala, South Cotabato
CLINICA OZARAGA	----->Bonifacio, Misamis Occidental
CLINICA PINEDA	----->Malalag, Davao del Sur
CLINICA RUDINAS & HOSPITAL	----->Hagonoy, Davao del Sur
CLINICA STA. TERESA	----->Malalag, Davao del Sur
CODILLA-RAMOS CLINIC AND HOSPITAL	----->Poblacion Esperanza Sultan Kudarat
COL. DOMINGO A. VALDEZ	----->MEMORIAL HOSPITAL (DASOL MUNICIPAL HOSPITAL) Dasol, Pangasinan
COMMUNITY HEALTH AND	----->DEVELOPMENT COOP. HOSPITAL Anda Riverside, City Proper Davao City
COMMUNITY GENERAL HOSPITAL	----->SAN PABLO CITY, INC. Colago Avenue, San Pablo City
COMMUNITY MEDICAL CLINIC	----->OF BALAGTAS, CO. Burol 1st, Balagtas, Bulacan
COMPOSTELA VALLEY HOSPITAL	----->Compostela, Compostela Valley
COMPOSTELA VALLEY	----->PROVINCIAL HOSPITAL Montevista, Compostela Valley
CONCEPCION DISTRICT HOSPITAL	----->Brgy. Alfonso, Concepcion Tarlac
CONG. LAMBERTO C. MACIAS	----->MEMORIAL HOSPITAL Siaton, Negros Oriental
CONG. NATALIO P. CASTILLO	----->SR. MEMORIAL HOSPITAL Loon, Bohol
CONG. SIMEON G. TORIBIO	----->MEMORIAL HOSPITAL Carmen, Bohol
CONNER DISTRICT HOSPITAL	----->Mabubua, Calafug Conner, Apayao
CONSUELO TAN MEMORIAL	----->MEDICAL CENTER Sogod, Southern Leyte
CONTRERAS MEDICAL CLINIC	----->Rosario, Cavite
CORADO MEDICAL CLINIC	----->AND HOSPITAL # 25 Tandang Sora St., Victory, Norte, Santiago City, Isabela
CORAZON LOCSIN MONTELIBANO	----->MEMORIAL REGIONAL HOSPITAL Lacson St., Bacolod City Negros Occidental
CORON DISTRICT HOSPITAL	----->Brgy. 5, Coron, Palawan
CORPUZ CLINIC AND HOSPITAL	----->Sinait, Ilocos Sur
CORROMPIDO SPECIALTY HOSPITAL	----->Sogod, South Leyte
CORTES MUNICIPAL HOSPITAL	----->Cortes, Surigao del Sur
COTABATO MEDICAL	----->SPECIALIST HOSPITAL Quezon Avenue, CotabatoCity, Maguindanao
COTABATO PROVINCIAL HOSPITAL (IPHO)	----->Armas, Kidapawan North Cotabato
COTABATO PUERRICULTURE CENTER	----->AND GENERAL HOSPITAL Don Rufino Alonzo St. Cotabato City, Maguindanao
COTABATO REGIONAL HOSPITAL	----->AND MEDICAL CENTER Rosary Heights, Cotabato City
COTABATO SANITARIUM HOSPITAL	----->S.K. Maguindanao, Cotabato City
CRISOSTOMO GENERAL HOSPITAL	----->Bacoor, Cavite
CRISTINO PARAGAS MEMORIAL	----->COMMUNITY HOSPITAL Quinipot, Zamboanga City
CRUZ-DALIDA MATERNITY	----->HOSPITAL, INC. F. Salvador Ave., Jordan Plains Subd. Brgy. Sta. Monica Novaliches, Quezon City
CRUZ RABE GENERAL HOSPITAL	----->37 Gen. Luna St., Tuktukan Taguig City
CRUZADO MEDICAL CLINIC	----->HOSPITAL AND PHARMACY Pikit, Northern Cotabato
CUARTERO GENERAL HOSPITAL	----->Navales St., Tandag Surigao del Sur
CUISON HOSPITAL, INC.	----->(formerly Cuison Family Clinic Hospital) Dagupan City
CULASI DISTRICT HOSPITAL	----->Culasi, Antique
CULION SANITARIUM	----->Culion, Palawan
CUYO DISTRICT HOSPITAL	----->Cuyo, Catadman, Palawan City
D.B.B. MUNICIPAL HOSPITAL	----->DBB, Dasmariñas Cavite
D.H. POLINTAN MEDICAL CLINIC	----->Poblacion, Macabebe, Pampanga
D.O. PLAZA MEMORIAL HOSPITAL	----->Patin-ay, Agusan del Sur
D. T. PROTACIO HOSPITAL	----->484 Quirino Ave., Tambo Street, Parañaque City
DAANBANTAYAN DISTRICT HOSPITAL	----->Daanbantayan, Cebu
DAGUPAN DOCTORS VILLAFLOR	----->MEMORIAL HOSPITAL Dagupan City
DAGUPAN ORTHOPEDIC CENTER	----->Tapuac District, Dagupan City
DANAO DISTRICT HOSPITAL	----->Danao, Cebu
DANAO MOTHER AND CHILD HOSPITAL	----->National Rd. Danao City
DANAO SALE MEDICAL CLINIC	----->Sta. Clara, Naga Zamboanga Sibucay
DANIEL MERCADO MEDICAL	----->CENTER (formerly Mercado Gen. Hosp.) Tanauan, Batangas
DATU BLAH T. SINSUAT DISTRICT	----->HOSPITAL UPI, Maguindanao
DATU HALUN SAKILAN	----->MEMORIAL HOSPITAL Bongao, Tawi-Tawi
DAVAO ADVENTIST HOSPITAL	----->Km. 7, McArthur Hi-way Bangkal, Davao City
DAVAO DEL SUR PROVINCIAL	----->HOSPITAL Digos, Davao del Sur
DAVAO DOCTORS HOSPITAL	----->Quirino Avenue, Davao City
DAVAO MEDICAL SCHOOL	----->FOUNDATION - HOSPITAL Bajada, Davao City
DAVAO MEDIQUEST HOSP. INC.	----->Toril, Davao City
DAVAO ORIENTAL PROVINCIAL	----->HOSPITAL Mati, Davao Oriental
DAVAO REGIONAL HOSPITAL	----->Apokon, Tagum City Davao del Norte
DAYOS-PASCUAL MEDICAL CLINIC	----->Roxas, Isabela
DE CASTRO HOSPITAL	----->FOUNDATION, INC. Milagros, Masbate
DE JESUS GENERAL HOSPITAL	----->5B. Aquino Ave. Baliuag, Bulacan
DE OCAMPO MEMORIAL MEDICAL CENTER	----->2921 Nagtahan Street Sta. Mesa, Manila
DE VERA'S MEDICAL CENTER	----->Santiago City, Isabela
DECENA GENERAL HOSPITAL	----->(formerly DECENA MEDICAL CLINIC) Bonuan, Dagupan City, Pangasinan
DEE HWA LIONG FOUNDATION	----->MEDICAL CENTER - ANGELES BRANCH Henson St., Brgy. Agapito del Rosario, Angeles City
DEIPARINE MEDICAL CLINIC	----->Sibonga, Cebu
DEL CARMEN DISTRICT HOSPITAL	----->Del Carmen, Surigao del Norte
DEL CARMEN MEDICAL CLINIC	----->Calauag, Quezon
DEL CARMEN MEDICAL CLINIC	----->AND HOSPITAL Carmen, Rosales, Pangasinan
DEL MONTE BUGO CLINIC	----->Bugo, Cagayan de Oro City
DELA CERNA MEDICAL CLINIC	----->Buhangin, Davao City
DELA CRUZ MATERNITY HOSPITAL	----->#910 Crescini St., Caridad Cavite City
DELA SALLE UNIVERSITY	----->MEDICAL CENTER Bagong Bayan, Dasmarinas Cavite
DELA SALLE UNIVERSITY- DR.	----->RODOLFO POBLETE MEM. HOSP. Burgos St., Alfonso, Cavite
DELBERT JON'S POLYCLINIC	----->Pob. Kapatagan, Lanao del Norte
DELFIN ALBANO COMMUNITY HOSPITAL	----->Delfin Albano, Isabela, Cagayan Valley
DELOS SANTOS - STI MEDICAL CENTER	----->201 E. Rodriguez Sr., Blvd. Quezon City
DELOS REYES MEDICAL CLINIC	----->Pinamalayan, Oriental Mindoro
DEMANO'S MEDICAL AND	----->PEDIATRIC CLINIC Ramon, Isabela
DENNIS MOLINTAS MUNICIPAL	----->HOSPITAL Daclan, Bokod, Benguet
DETECIO COMMUNITY HOSPITAL	----->Malay-balay City, Bukidnon
DIFFUN DISTRICT HOSPITAL	----->Diffun, Quirino
DIGNUM FOUNDATION	----->HOSPITAL INC. Langcangan, Oroquieta City Misamis Occidental
DIGOS DOCTOR'S HOSP., INC.	----->Digos, Davao del Sur
DIHMESCO GENERAL HOSPITAL	----->(formerly Divine Heart Medical Services Dev't Coop.) 215 Gen. Luis St., Novaliches Quezon City
DIMIAO MUNICIPAL INFIRMARY	----->Nat'l. Hi-way, Pob., Dimiao, Bohol
DINAGAT DISTRICT HOSPITAL	----->Dinagat, Surigao del Norte
DINAIG MUNICIPAL HOSPITAL	----->Dalican, Maguindanao
DINGRAS DISTRICT HOSPITAL	----->Bo. Suyo, Dingras, Ilocos Norte
DIONES HOSPITAL	----->Sulop, Davao del Sur
DIOSDADO P. MACAPAGAL	----->MEMORIAL HOSPITAL (formerly Pampanga Provincial Hospital) Sta. Rita-Guagua, Pampanga
DIPOLOG MEDICAL CENTER, INC.	----->Dipolog City, Zamboanga
DIVINE CARE HOSPITAL	----->MULTI SERVICES CORP Nar'l. Hi-way Sico II, San Juan Batangas
DIVINE GRACE MEDICAL CENTER	----->(formerly DIVINE GRACE HOSPITAL AND MATERNITY CENTER) Rosario, Cavite Bypass Rd., Bacao, Tejero Gen. Trias, Cavite
DIVINE LOVE GENERAL HOSPITAL	----->Lipa City, Batangas
DIVINE MERCY FOUNDATION OF	----->URDANETA HOSPITAL Urdaneta City, Pangasinan
DIVINE MERCY HOSPITAL	----->Mac Arthur Hi-way Anupul, Bamban, Tarlac
DIVINE MERCY HOSPITAL	----->San Pedro, Laguna
DIVINE WORD HOSPITAL	----->Hagonoy, Bulacan
DIVINE WORD HOSPITAL	----->Avenida Veteranos Tacloban City
DIZON MEDICAL CLINIC & HOSPITAL	----->J. P. Laurel St., Kidapawan City
DOLORES MEDICARE AND	----->COMMUNITY HOSPITAL Dolores, Abra
DOLORES MUNICIPAL HOSPITAL	----->Dolores, Eastern Samar
DOMINGO CASANO HOSPITAL	----->Dolores, Eastern Samar
DOMINICAN HOSPITAL, INC.	----->Quezon Avenue, Digos City Davao del Sur
DON CIRIACO S.TIROL SR.	----->MEMORIAL HOSPITAL Boracay Island, Malay, Aklan
DON EMILIO DEL VALLE	----->MEMORIAL HOSPITAL Ubay, Bohol
DON JOSE S. MONFORT MEDICAL	----->CENTER EXT. HOSPITAL Barotac, Nuevo Iloilo
DON JUAN MAYUGA	----->MEMORIAL HOSPITAL Lemery, Batangas
DON LEOVIGILDO DIAPO SR.	----->MUNICIPAL HOSPITAL Madalag, Aklan
DON MANUEL LOPEZ MEMORIAL	----->DISTRICT HOSPITAL Balayan, Batangas
DON MARIANO C. VERZOSA	----->MEMORIAL HOSPITAL (former Lingayen District Hosp.) V. Solis St., Lingayen, Pangasinan 20
DON MODESTO FORMILLEZA	----->SR. MEMORIAL HOSPITAL Punta, Looc, Romblon
DON RAMON TUGBANG	----->MEDICAL CENTER (formely Barotac Viejo Medical Center Inc.) Zulueta Drive, Barotac Viejo, Iloilo
DON SALVADOR BENEDICTO	----->MEMORIAL DISTRICT HOSPITAL La Carlota City, Negros Occ.
DON SANTIAGO A. NAHIAL SR.	----->MEMORIAL HOSPITAL Dinas, Zamboanga Del Sur
DON VALERIO PALMARES, SR.	----->MEMORIAL DISTRICT HOSPITAL Alfelor St., Passi City, Iloilo
DOÑA JOSEFA EDRALIN	----->MARCOS DISTRICT HOSPITAL Marcos, Ilocos Norte
DOÑA MARIA D. TAN	----->MEMORIAL HOSPITAL Baybay Mantio, Tangub City Misamis Occidental
DONA MARTA MEMORIAL	----->DISTRICT HOSPITAL Atimonan, Quezon
DONSOL DISTRICT HOSPITAL	----->Donsol, Sorsogon
DR. A. P. ZANTUA GE. HOSPITAL	----->Virac, Catanduanes
DR. ADOLFO O. FLORES	----->MEMORIAL HOSPITAL Villasis, Santiago City
DR. ALBERTO M. PASTOR	----->HOSPITAL Salawagan, Quezon, Bukidnon
DR. AMADO DIAZ PROVINCIAL	----->FOUNDATION HOSPITAL Midsayap, North Cotabato
DR. AMANDO D. COPE	----->MEMORIAL HOSPITAL Tabaco, Albay
DR. AMANDO L. GARCIA MEDICAL	----->CENTER 648 Rizal St., Angeles City
DR. ANTONIO RANADA	----->LYING-IN AND HOSPITAL Brgy. 7-A Hernadez Ave. Laoag City
DR. APOLLO DUQUE MEMORIAL	----->HOSPITAL Cabiao, Nueva Ecija
DR. ATANACIO T. DAYRIT, JR.	----->MEDICAL HOSPITAL Centro, Cabatuan, Isabela
DR. B.G. DONASCO MEDICAL	----->CLINIC & HOSPITAL 27 Brgy. Paciano, Rizal, Calamba City, Laguna
DR. BERNARDO B. CORRAL	----->MEMORIAL HOSPITAL (former St. Claire Medical Clinic) Tiwi, Tabaco City
DR. BONIFACIA V. ALBANO	----->MEMORIAL HOSPITAL Bacarra, Ilocos Norte
DR. DAMIAN REYES . H. HOSPITAL	----->(formerly Marinduque Provincial Hospital) Boac, Marinduque
DR. EMIGDIO C. CRUZ SR.	----->MEMORIAL HOSPITAL San Agustin, Arayat, Pampanga
DR. ERLINDA B. ESTANISLAO	----->MEMORIAL HOSPITAL Pio Duran, Albay
DR. ERLINDA P. TOLENTINO	----->MEDICAL CLINIC & HOSPITAL Unisan, Quezon
DR. ERVIN B. LUNTAO FAMILY	----->CLINIC AND HOSPITAL National Hi-way, Pob. Sto Nino South Cotabato
DR. ESTEBAN V. ANTE	----->MEMORIAL HOSPITAL Rizal St., Legazpi City
DR. ESTER GARCIA GENERAL	----->HOSPITAL San Fermin, Cauayan City, Isabela
DR. FE DEL MUNDO MEDICAL	----->CENTER FOUNDATION PHILS. 11 Banaue Street, Quezon City
DR. EUTIQUIO LL. ALANACIO JR.	----->MEMORIAL HOSPITAL (formerly Sta. Rita Hospital)
DR. FERNANDO B. DURAN SR.	----->MEMORIAL HOSPITAL Macabog, Sorsogon
DR. GLORIA D. LACSON	----->GEN. HOSPITAL San Leonardo, Nueva Ecija
DR. GREGORIO B. TAN	----->MEMORIAL HOSPITAL Laoang, Northern Samar
DR. GUMERSINDO GARCIA SR.	----->MEMORIAL HOSPITAL Kabankalan City, Negros Occ.
DR. HENRY M. DE VILLA	----->MEMORIAL HOSPITAL (former St. Joseph Clinic) Ipil, Zamboanga Sibugay
DR. HERNAN SORONGON SR. HOSPITAL	----->M'lang, North Cotabato
DR. IGNACIO M. CORTEZ	----->GENERAL HOSPITAL Mandaue City, Cebu
DR. ILDEFONSO ALCANTARA	----->MEMORIAL HOSPITAL Dalaguete, Cebu
DR. JANET TUMOLVA	----->LUSUNG MEDICAL CLINIC AND LYING-IN Delfin Albano, Isabela
DR. JESUS C. DELGADO	----->MEMORIAL HOSPITAL 7 Kamuning Road, Qeuzon City
DR. JOSE FABELLA MEMORIAL HOSPITAL	----->Lope de Vega St., Sta. Cruz, Manila
DR. JOSE R. REYES MEMORIAL	----->MEDICAL CENTER Rizal Avenue, Sta. Cruz, Manila
DR. JOSE P. RIZAL MEMORIAL	----->DISTRICT HOSPITAL Bucal, Calamba, Laguna
DR. JOSE RIZAL MEMORIAL HOSPITAL	----->Dapitan City, Zamboanga del Norte
DR. JOSE N. RODRIGUEZ	----->MEMORIAL HOSPITAL Tala, Caloocan City
DR. JOSE MA. V. BORROMEO	----->MEMORIAL HOSPITAL Pandacan, Pinamungahan, Cebu
DR. JOSE MA. TORRES MEMORIAL	----->FOUNDATION HOSP., INC. Lamitan, Basilan
DR. LIM'S CLINIC AND HOSPITAL	----->Valencia, Bohol
DR. LORENZO B. PRINCIPE	----->CLINIC AND DRUGSTORE Calinan, Davao del Sur
DR. LUIS P. MALALUAN HOSPITAL	----->Poblacion, Kidapawan North Cotabato
DR. MANUEL R. REBUENO	----->MEMORIAL HOSPITAL Oas, Albay
DR. MANUEL VELOSO	----->MEMORIAL HOSPITAL Palompon, Leyte
DR. MARCELO M. CHAN	----->MEMORIAL HOSPITAL Carmen,Rosales, Pangasinan
DR. MARIO D. BEJASA	----->GENERAL HOSPITAL Bauan, Batangas
DR. MIGUEL V. ALEGRE	----->HOSPITAL Labo, Camarines Norte
DR. MIRANDO C. UNCIANO	----->SR. MEDICAL CENTER V. Mapa St., Sta. Mesa Manila
DR. MONTANO G. RAMOS HOSPITAL	----->46 Bukidnon St., Bago Bantay Quezon City
DR. MONTANO G. RAMOS	----->HOSPITAL Mindanao Avenue Bahay Toro, Quezon City
DR. NILO O. ROA MEMORIAL	----->FOUNDATION HOSPITAL Naga City
DR. NOEL DE LEON	----->MATERNITY CLINIC Vira, Roxas, Isabela
DRA. OLIVIA SALAMANCA	----->MEMORIAL DISTRICT HOSPITAL Gomez St., Cavite
DR. PABLO O. TORRE SR.	----->MEMORIAL HOSPITAL Sen. B. Aquino Drive Bacolod City, Negros Occidental
DR. PAULINO J. GARCIA MEMORIAL	----->RESEARCH & MEDICAL CENTER Mabini St., Cabanatuan City, Nueva Ecija
DR. PETRONILO V. SEARES	----->SR. , MEMORIAL HOSPITAL Penarubia St., Bangued, Abra
DR. RAFAEL S. TUMBOKON	----->MEMORIAL PROVINCIAL HOSPITAL Kalibo, Aklan
DR. RAMON B. LEGASPI SR.	----->MEMORIAL HOSPITAL Makato, Aklan
DR. RICARDO S. PROVIDO SR.	----->MEMORIAL DISTRICT HOSPITAL Calinog, Iloilo City
DR. RICARDO Y. LADRIDO	----->MEMORIAL HOSPITAL Ladrido St., Lambunao, Iloilo
DR. ROBOSA HOSPITAL	----->Baao, Camarines Sur
DR. ROLAND P. DELA	----->CRUZ MEMORIAL HOSPITAL National Hi-way, Midsayap North Cotabato
DR. ROMEO ISANA ROSALES	----->GENERAL HOSPITAL Brgy. Road Pob., P. Garcia Batangas
DR. SABILI GENERAL HOSPITAL	----->AND HEALTH SERVICES 313 Gen. Santos Ave. L. Bicutan, Taguig
DR. SERAPIO M. MONTANER JR.	----->AL-HAJ PROVINCIAL HOSPITAL Malabang, Lanao del Sur
DR. SOFRONIO B. GARCIA	----->MEMORIAL HOSPITAL Ligao City, Albay
DR. TOMAS L. NOLASCO SR.	----->MEMORIAL HOSPITAL Centro Gatarao, Gattaran Cagayan Valley
DR. UY HOSPITAL, INC.	----->19 Roxas Ave., Iligan City Lanao del Norte
DR. VICTOR POTENCIANO	----->MEDICAL CENTER 163 Edsa, Mandaluyong City
DR. VICTOR S. VILLAROMAN	----->MEMORIAL HOSPITAL Burgos St., Ilagan, Isabela
DR. YANGA'S HOSPITAL, INC.	----->Poblacion, Bocaue, Bulacan
DRA. ARACELI D. MENDOZA	----->MEMORIAL MEDICAL CLINIC (formerly Holy Family Medical Clinic) 24 Int. C.M Recto Ave. Lipa City
DRA. OLIVIA SALAMANCA	----->MEMORIAL DISTRICT HOSPITAL P. Gomez St., Cavite City
DRAZEN MEDICAL HOSPITAL	----->Sinacaban, Misamis Occidental
DUAY HOSPITAL	----->Brgy. Tolosa, Cabadbaran Agusan del Norte
DUBONGCO'S MEDICAL CLINIC	----->Rosero St., Masbate City
DUMANGAS DISTRICT HOSPITAL	----->Dumangas, Iloilo
DUAY HOSPITAL	----->Brgy. Tolosa, Cabadbaran Agusan Del Norte
DUBONGCO'S MEDICAL CLINIC	----->Rosero St., Masbate City
DUMANGAS DISTRICT HOSPITAL	----->Dumangas, Iloilo
DUMDUM MEDICAL CLINIC	----->Balamban, Cebu
DUMLAO HOSPITAL	----->Roxas, Isabela
DUPAX DISTRICT HOSPITAL	----->Dupax del Norte, Nueva Viscaya
DUQUE GENERAL HOSPITAL	----->San Juan, Batangas
E.B. MERCADO MEDICAL CLINIC	----->Kapatagan, Davao Del Sur
E.D. LIM MATERNITY AND	----->GENERAL HOSPITAL Apalit, Pampanga
E.L. JOSON MEMORIAL HOSPITAL	----->Cabanatuan City
E & R HOSPITAL & PHARMACY	----->Bo. C. Labao Ext., Iligan City
E.S. GARCIA HOSPITAL	----->170 Malusak St., Sta Ana Bulacan, Bulacan
E. ZARATE HOSPITAL	----->Talon, Las Piñas City
EAST AVENUE MEDICAL	----->CENTER East Avenue, Quezon City
EASTERN BICOL	----->MEDICAL CENTER Virac, Catanduanes
EASTERN PANGASINAN	----->DISTRICT HOSPITAL Tayug, Pangasinan
EASTERN SAMAR PROVINCIAL	----->HOSPITAL Borongan, Eastern Samar
EASTERN VISAYAS REGIONAL	----->MEDICAL CENTER R. Magsaysay Blvd. Tacloban City, Northern Leyte
ECHAGUE DISTRICT HOSPITAL	----->(PRIMO GAFFUD DIST. HOSP.) Ipil Echague, Isabela
ED AND TITA CRUZ MATERNITY	----->AND SURGICAL HOSPITAL Bagbaguin, Sta. Maria, Bulacan
EDIBORAH T. YAP MEMORIAL	----->HOSPITAL Lamitan, Basilan
EDWIN ANDREW'S AIRBASE	----->HOSPITAL Sta. Maria, Zamboanga City
ELEUTERIO T. DECENA	----->MEMORIAL HOSPITAL Bacuyangan, Hinobaan, Negros Occidental
ELGUIRA GENERAL HOSPITAL	----->Rizal Ave., San Carlos City Pangasinan
ELVIN U. MASIGAN INTEGRATED	----->MEMORIAL HOSPITAL Sta. Maria, Isabela
EMIL JOANNA GENERAL	----->HOSPITAL 147 Quezo St., Atimonan, Quezon
EMILIO AGUINALDO COLLEGE	----->MEDICAL CENTER - CAVITE Brgy. Salitran II Dasmarinas Cavite
EMILIO G. PEREZ MEMORIAL	----->HOSPITAL Sto. Niño, Hagonoy, Bulacan
EMMANUEL HOSPITAL	----->San Jose, San Miguel, Bulacan
ENGLEWOOD HOSPITAL	----->Tagbilaran City
ERMAVI HOSPITAL	----->Kibawe, Bukidnon
ERNESTO GUADALUPE MEDICAL	----->CLINIC AND LABORATORY Daliao, Toril, Davao City
ESCOLASTICA ROMERO	----->DISTRICT HOSPITAL San Nicolas 1st., Lubao Pampanga
ESPERANZA MEDICARE	----->COMMUNITY HOSPITAL Esperanza, Agusan del Sur
ESPINOZA-ROSARIO HOSPITAL	----->Malasiqui, Pangasinan
ESPIRITU MEDICAL CLINIC	----->AND HOSPITAL Sto. Tomas, Davao Del Norte
ESTACION MEDICAL CLINIC	----->AND HOSPITAL Malita, Davao del Sur
ESTELA MEDICAL CLINIC	----->AND PHARMACY Sto. Tomas, Davao del Norte
ESTEVEZ MEMORIAL HOSP., INC.	----->Legaspi City
ESTHER HOSPITAL	----->Pob. Highway, Valencia City Bukidnon
ESTRELLA HOSPITAL	----->Aguin H-way, Silang, Cavite
EUSER MEDICAL HOSPITAL	----->Tambulig, Zamboanga del Sur
EUSTAQUIO MEDICAL AND	----->OB-GYNE MEDICAL CLINIC Plazang Luma, Arayat, Pampanga
EVANGELISTA MEDICAL CLINIC	----->AND HOSPITAL Lambayong, Sultan Kudarat
EVANGELISTA MEDICAL AND	----->SPECIALTY HOSPITAL San Pedro, Laguna
EVERSLEY CHILDS SANITARIUM	----->Mandaue City
F. DAGOHOY MUNICIPAL HOSPITAL	----->Inabanga, Bohol
F.E.U. - NICANOR REYES MEDICAL	----->FOUNDATION MEDICAL CENTER Regalado Ave., Fairview, Quezon City
F & P HERNANDEZ MATERNITY	----->AND LYING-IN CLINIC McArthur Highway, Valenzuela City
F. Y. MANALO MEDICAL	----->FOUNDATION, INC. NEW ERA GEN. HOSPITAL Commonwealth Ave., cor Tandang Sora, New Era Quezon City
FAIRVIEW GENERAL HOSPITAL	----->L20 cor. Mercury Street Quezon City
FAITH HOSPITAL	----->Ozamis City
FAMILY CARE HOSPITAL, INC.	----->San Pedro, Laguna
FAMILY MEDICAL CLINIC	----->#4 Caramcam District, Mangagoy Bislig City, Surigao del Sur
FANLO MEDICAL CLINIC	----->Malita, Davao del Sur
FAR NORTH LUZON GEN.	----->HOSP. & TRAINING CENTER Pob. Luna, Apayao
FATIMA UNIVERSITY MEDICAL	----->CENTER, INC. 120 McArthur Highway Valenzuela City
FEDERICO ROMAN TIRADOR SR.	----->MEMORIAL DISTRICT HOSPITAL Janiuay, Iloilo
FELIPE ABRIGO MEMORIAL	----->HOSPITAL Guiuan, Eastern Samar
FERNANDO AIR BASE HOSPITAL	----->Lipa City, Batangas
FIGUERRES CLINIC & HOSPITAL	----->Vigan, Ilocos Sur
FIRST FILIPINO SAINT HOSPITAL	----->(SAN LORENZO RUIZ) Brgy. San Roque, Naic, Cavite
FLORA DISTRICT HOSPITAL	----->Flora, Apayao
FLORDELIZ MEDICAL CLINIC	----->Mawab, Campostela Valley
FLORANTE V. BERNABE, SR.	----->MEMORIAL HOSPITAL Quirino Ave., La Huerta Paranaque City
FORT BONIFACIO GENERAL HOSPITAL	----->Fort Andres Bonifacio Makati City
FORT DEL PILAR STATION HOSPITAL	----->PMA, Fort Del Pilar Baguio City
FORT MAGSAYSAY ARMY	----->STATION HOSPITAL 7th Infantry Division, Phil. Army Fort Ramon Magsaysay Palayan City, Nueva Ecija
FR. GERRY FILIPPETTO MEMORIAL	----->FOUNDATION HOSPITAL Sta Cruz, Cagayan
FR. TULIO FAVALI MUNICIPAL	----->HOSPITAL Tulunan, North Cotabato
FRANCISCO GENERAL HOSPITAL	----->Urdaneta City, Pangasinan
FRANCO MEDICAL CLINIC	----->AND HOSPITAL Trento, Agusan Del Sur
G. GONZALES MEDICAL CLINIC	----->Tiwi, Albay
G.M.A. MEDICARE HOSPITAL	----->G.M.A., Cavite
GABALDON MEDICARE	----->COMMUNITY HOSPITAL Gabaldon, Nueva Ecija
GABRIELA SILANG GENERAL	----->HOSPITAL Tamag, Vigan, Ilocos Sur
GALINATO FAMILY CLINIC & HOSPITAL	----->Guyabano St., Kalawag II Isulan, Sultan Kudarat
GAMAY DISTRICT HOSPITAL	----->Gamay, Northern Samar
GAMBALAN HOSPITAL	----->San Antonio Delfin, Albano, Isabela 8
GAMEZ HOSPITAL	----->218 J. P. Rizal St., Calamba Laguna
GANDARA DISTRICT HOSPITAL	----->Gandara, Western Samar
GAOAT GENERAL HOSPITAL	----->Brgy. 11 Ben Agan, Batac Ilocos Norte
GAPAN DISTRICT HOSPITAL	----->Bayanihan, Gapan, Nueva Ecija
GARCHITORENA MEDICARE	----->COMMUNITY HOSPITAL Garchitorena, Camarines Sur
GARCIA GENERAL HOSPITAL	----->49 B. Bayanan Ave. Concepcion, Marikina City
GARCIA MEMORIAL PROVINCIAL	----->HOSPITAL Talibon, Bohol
GAT ANDRES BONIFACIO	----->MEMORIAL MEDICAL CENTER Delpan St., Tondo, Manila
GATA GENERAL HOSPITAL	----->Guinobatan, Albay
GATTARAN EMERGENCY HOSPITAL	----->Calaoagan, Dakkel, Cagayan
GEMARINO HOSPITAL	----->Diplahan, Zamboanga Sibugay
GEN. EMILIO AGUINALDO	----->MEMORIAL HOSPITAL Luciano, Trece Martires City, Cavite
GEN. J. CAILLES MEMORIAL HOSPITAL	----->Tavera, Pakil, Laguna
GEN. MAC ARTHUR MUNICIPAL	----->HOSPITAL Gen. MacArthur, Eastern Samar
GEN. MIGUEL MALVAR MEDICAL	----->FOUNDATION HOSPITAL 531 Commonwealth, Quezon City
GEN. SANTOS CITY HOSPITAL	----->Gen. Santos City, South Cotabato
GEN. TINIO MEDICARE AND	----->COMMUNITY HOSPITAL General Tinio, Nueva Ecija
GEN. TRIAS MATERNITY AND	----->PEDIATRIC HOSPITAL Gen. Trias, Cavite
GEN. TRIAS MEDICARE	----->HOSPITAL Pinagtipunan, Gen. Trias, Cavite
GEORGE DEWEY MEDICAL AND	----->WELLNESS CENTER Olongapo City, Zambales
GERONA HOSPITAL OF THE	----->SACRED HEART Abagon, Gerona, Tarlac
GERTES CLINIC AND HOSPITAL	----->Brgy# 15 San Nicolas, Ilocos Norte 10
GIGAQUIT MUNICIPAL HOSPITAL	----->Gigaquit, Surigao del Norte
GIGMOTO DISTRICT HOSPITAL	----->Gigmoto, Catanduanes
GIG. OCA ROBLES SEAMEN'S HOSPITAL	----->R. Castillo St., Davao City
GILBERTO O. TEODORO	----->MEMORIAL HOSPITAL Brgy. Malacampa, Camiling, Tarlac 25
GINES HOSPITAL	----->Roxas St, Cauayan, Isabela
GINGOOG SANITARIUM AND	----->HOSPITAL, INC. Bagaipo St., Gingoog City Misamis Oriental
GLAN MEDICARE COMMUNITY	----->HOSPITAL Glan, Sarangani
GLORIA MEDICARE	----->COMMUNITY HOSPITAL Gloria, Oriental Mindoro
GOLDEN ACRES DOCTOR'S	----->HOSPITAL Talon V, Las Piñas City
GOLDEN GATE GENERAL	----->HOSPITAL Batangas City
GOLINGAY GENERAL HOSPITAL	----->Malalag, Davao del Sur
GONZAGA COMMUNITY CLINIC	----->Gonzaga, Cagayan
GONZALES GENERAL HOSPITAL	----->San Leonardo, Nueva Ecija
GONZALES MARANAN CLINIC	----->AND HOSPITAL Digos City, Davao del Sur
GONZALES MEDICAL AND	----->CHILDRENS HOSPITAL Tanauan City, Batangas
GOOD NEWS CLINIC	----->Banawe, Ifugao
GOV. CELESTINO GALLARES	----->MEMORIAL HOSPITAL Tagbilaran City, Bohol
GOV. FAUSTINO N. DY SR.	----->MEMORIAL HOSPITAL Ilagan, Isabela
GOV. GENEROSO MUNICIPAL	----->HOSPITAL Gov. Generoso, Davao Oriental
GOV. ROQUE B. ABLAN SR.	----->MEMORIAL HOSPITAL P. Gomez, Laoag City Ilocos Norte
GOV. WILLIAM "BILLY" VILLEGAS	----->MEMORIAL HOSPITAL Guihulngan, Negros Oriental
GOV. VALERIANO GATUSLAO	----->MEMORIAL DIST. HOSP. Himamaylan, Negros Occidental
GOZO COMMUNITY HOSPITAL	----->Maranding, Lala, Lanao Del Norte
GRACE CHRISTIAN CLINIC	----->AND HOSPITAL 03 Capitol Road, Surigao City Surigao del Norte
GRACE MEMORIAL HOSPITAL	----->FOUNDATION, INC. (formerly Grace Memorial Maternity and General Hospital) 003 Burol 2nd, Balagtas, Bulacan
GRACE MISSION HOSPITAL	----->Katiningan, Socorro Oriental Mindoro
GREAT SAVIOUR INTERNATIONAL	----->HOSPITAL, INC. Solis St., Tap-oc, Molo, Iloilo City
GREG HOSPITAL - SARIAYA, INC	----->Gen Luna St., Sariaya, Quezon
GREGORIO DEL PILAR	----->DISTRICT HOSPITAL Bagumbayan, Balagtas, Bulacan
GREGORIO T. LLUCH MEMORIAL	----->HOSPITAL Pala-o, Iligan City
GREGORIO MATAS DISTRICT	----->HOSPITAL Kibiawan, Davao del Sur
GUBA COMMUNITY HOSPITAL	----->Guba, Cebu
GUBAT DISTRICT HOSPITAL	----->Gubat, Sorsogon
GUBATAN CLINIC	----->Burol 2nd, Balagtas, Bulacan
GUIMARAS PROVINCIAL	----->HOSPITAL (IPHO) San Miguel Jordan, Guimaras
GUIMBA DISTRICT HOSPITAL	----->Pacac, Guimba, Nueva Ecija
GUIMBA GENERAL HOSPITAL	----->Guimba, Nueva Ecija
GUINAYANGAN MEDICARE	----->COMMUNITY HOSPITAL Guinayangan, Quezon
GUMACA DISTRICT HOSPITAL	----->Gumaca, Quezon
HCGC MEDICAL PLAZA	----->260 San Jose St., Carmona Cavite
H.M. CORACHEA GENERAL	----->HOSPITAL Tanauan City, Batangas
H. VILL HOSPITAL	----->Manggahan, Rodriguez, Rizal
H.W. MILLER MEMORIAL	----->SANITARIUM AND HOSPITAL 400 Tres de Abril St., Cebu City
HEALTH SERVICES LOS BANOS	----->HOSPITAL AND MEDICAL CENTER Los Banos, Laguna
HEART OF JESUS HOSPITAL	----->San Jose City, Nueva Ecija
HERAMIL'S MATERNITY AND	----->CHILDREN'S HOSPITAL Polomolok, South Cotabato
HILONGOS DISTRICT HOSPITAL	----->Hilongos, Northern Leyte
HINATUAN DISTRICT HOSPITAL	----->Hinatuan, Surigao del Sur
HINIGARAN MEDICAL CLINIC	----->Hinigaran, Negros Occidental
HINUNANGAN COMMUNITY HOSPITAL	----->Hinunangan, Southern Leyte
HOFILEÑA HOSPITAL	----->Pagadian City
HOLY CHILD OF BUTUAN HOSPITAL , INC.	----->102 South Drive, Guingona Subd. Agusan del Norte
HOLY CHILD HOSPITAL	----->Dumaguete City, Negros Oriental
HOLY CHILD MATERNITY	----->AND CHILDREN'S CLINIC Ambrosio St., Urdaneta City
HOLY FAMILY HOSPITAL	----->Bongao, Tawi-Tawi
HOLY FAMILY MEDICAL CENTER	----->Sto. Cristo, Angeles City, Pampanga
HOLY INFANT CLINIC	----->Roxas Avenue, Tuguegarao City
HOLYLIFE HEALTHCARE CENTER	----->Pres. Quezon Ave. Lifehomes Subd. Rosario, Pasig City
HOLY NAZARENE CLINIC	----->AND HOSPITAL Valdez St., Kalawag II Isulan, Sultan Kudarat
HOLY ROSARY HOSPITAL	----->San Isidro, Lopez, Quezon
HOLY SPIRIT OF MINTAL CLINIC	----->Sampaguita St., Mintal Davao City
HOLY TRINITY HOSPITAL	----->(former Jose S. Domingo Hosp.) 505 Quezon St. San Miguel, Tarlac City
HOLY TRINITY MEDICAL CLINIC	----->Tabuk, Kalinga
HOLY TRINITY PLAZANG LUMA	----->MEDICAL CLINIC Plazang Luma, Arayat, Pampanga
HOMONHON ISLAND	----->COMMUNITY HOSPITAL Homonhon Island, Eastern Samar
HOSPITAL DE SAN JUAN BAUTISTA	----->Kap Isko Brgy II, Lian, Batangas
HOSPITAL OF THE HOLY CROSS	----->VR Medrano Calapan City Oriental Mindoro
HOSPITAL OF THE INFANT JESUS	----->1556 Laong Laan St. Sampaloc, Manila
HOWARD HUBBARD	----->MEMORIAL HOSPITAL Polomolok, South Cotabato
HUNGDUAN MUNICIPAL HOSPITAL	----->Hungduan, Ifugao
IBAJAY DISTRICT HOSPITAL	----->Ibajay, Aklan
IFUGAO GENERAL HOSPITAL	----->Lagawe, Ifugao
IGNACIO L. ARROYO SR.,	----->MEMORIAL DISTRICT HOSPITAL Burgos St., Isabela Negros Occidental
ILIGAN MEDICAL CENTER HOSPITAL	----->San Miguel Village, Pala-o Iligan City, Lanao Del Norte
ILOCOS MED. AND HEALTH	----->SERVICES COOPERATIVE (ST. THERESE HOSP.) San Lorenzo, Ilocos Norte
ILOCOS SUR COOPERATIVE	----->MEDICAL MISSION GROUP AND HOSPITAL Jose Singson, Vigan City
ILOCOS TRAINING AND	----->REGIONAL MEDICAL CENTER San Fernando City, La Union
ILOILO DOCTOR'S	----->HOSPITAL INC. West Avenue, Molo, Iloilo
ILOILO MISSION HOSPITAL	----->Mission Road, Jaro, Iloilo
ILOILO PROVINCIAL HOSPITAL	----->Pototan, Iloilo
IMMACULATE CONCEPCION	----->CLINIC AND HOSPITAL Guiuan, Eastern Samar
IMMACULATE CONCEPCION	----->HEALTH CENTER Victorias City, Negros Occidental
IMMACULATE CONCEPCION	----->HOSPITAL, INC. San Pablo City
IMMACULATE CONCEPCION	----->MEDICAL CENTER OF CENTRAL LUZON, INC. Circumference Road San Juan, Cabanatuan City Nueva Ecija
IMMACULATE CONCEPCION	----->POLYCLINIC AND HOSPITAL Green Vill., Concepcion, Tarlac
IMMACULATE HEART OF	----->MARY HOSPITAL Raines Virac, Catanduanes
IMUS FAMILY HOSPITAL	----->Justine Ville II Subd., Imus, Cavite
INAPOY COMMUNITY PRIMARY	----->HOSPITAL Mabinay, Negros Oriental
INFANTE HOSPITAL	----->MANAGEMENT CORPORATION Isabela City, Basilan
INTERGRATED CITY HEALTH OFFICE	----->(formerly Palayan City Emergency Hospital) Palayan City, Nueva Ecija
IPIL DOCTORS HOSPITAL	----->Ipil, Sibugay, Zamboanga
IROSIN DISTRICT HOSPITAL	----->Irosin, Sorsogon
ISAAC & CATALINA MED. CENTER	----->Capitol Drive, Balanga City Bataan
ISAAC T. ROBILLO MEMORIAL	----->HOSPITAL Calinan, Davao City
ISABELA DOCTOR'S GEN. HOSP.	----->Baligatan, Ilagan City, Isabela
ISIDRO C. KINTANAR	----->MEMORIAL HOSPITAL Argao, Cebu
ISIDRO M. OLAN SR. MEMORIAL	----->CLINIC AND HOSPITAL Pagantayan, Cantilan Surigao del Sur
ISIP GENERAL HOSPITAL	----->Polangui, Albay
ISULAN DOCTORS SPECIALIST	----->CENTER, INC. National Highway, Isulan Sultan Kudarat
ITBAYAT DISTRICT HOSPITAL	----->Itbayat, Batanes
ITOGON MUNICIPAL HOSPITAL	----->Bagueng Tinogdan, Itogon Benguet
J. CABAHUG HOSPITAL	----->Cabrera St., Pagadian City
J. HAGONOY MEDICAL CLINIC	----->Hagonoy, Davao Del Sur
J. P. SIOSON GENERAL HOSPITAL	----->AND COLLEGES, INC. 75 Bukidnon St., Bago Bantay Quezon City
J.R. BORJA MEMORIAL CITY HOSPITAL	----->Cagayan de Oro City
JVF CLINIC & LYING-IN MEMORIAL HOSPITAL	----->Cor. Rivera Zamora, Dagupan City, Pangasinan
JABONGA MUNICIPAL HOSPITAL	----->Jabonga, Agusan Del Norte
JACALAN HOSPITAL	----->Abadilla Subd., Pob. Tacurong City, Sultan Kudarat
JAIME B.BERCES MEMORIAL	----->HOSPITAL Tabaco City, Albay
JAMELARIN HOSPITAL (formerly	----->Pagadian Community Hospital) Bagong Silang, Balangasan District Pagadian City, Zamboanga del Sur 24
JAMES L. GORDON MEMORIAL	----->HOSPITAL New Asinan, Olongapo City,
JANE COUNTY HOSPITAL	----->C. M. Recto St., Pagbilao, Quezon
JANUARIA MARCIAL	----->MEMORIAL HOSPITAL Banga, South Cotabato
JASAAN MUNICIPAL HOSPITAL	----->(formerly JASAAN HOSPITAL) Jasaan, Misamis Oriental
JAVILLONAR CLINIC AND HOSPITAL	----->73 Dr. Pilapil St., Sagad Street Pasig City
JAVONILLO HOSPITAL	----->Nat'l H-Way, Magsaysay Cordon, Isabela
JECSONS MEDICAL CENTER	----->San Nicolas, Tarlac City
JESUS COLMENARES DISTRICT	----->HOSPITAL (formerly Aleosan District Hospital) Balasan, Iloilo
JESUS IMMACULATE	----->CONCEPCION HOSPITAL Katipunan Avenue Concepcion, Marikina City
JESUS NAZARENE GENERAL HOSPITAL	----->Solis St., Lingayen, Pangasinan
JESUS OF NAZARETH HOSPITAL	----->Guiguinto, Bulacan
JESUS THE GOOD SHEPHERD HOSPITAL	----->National Road, Poblacion Pulilan, Bulacan
JESUS THE SAVIOR HOSPITAL	----->Sto. Angel Central Sta. Cruz, Laguna
JNRAL FAMILY GENERAL HOSPITAL	----->Tanza, Cavite
JOHN PAUL HOSPITAL	----->26 Mariano Ponce cor. Tirad Pass Street, Caloocan City
JONES MEDICARE COMMUNITY	----->HOSPITAL Jones, Isabela
JOSE B. LINGAD MEMORIAL	----->REGIONAL HOSPITAL Dolores, San Fernando City, Pampanga
JOSE C. PAYUMO, JR.	----->MEMORIAL HOSPITAL San Ramon, Dinalupihan, Bataan
JOSE PANGANIBAN PRIMARY	----->SERVICE COOPERATIVE HOSP. Jose Panganiban Camarines Norte
JOSE R. REYES MEMORIAL	----->MEDICAL CENTER Sta. Cruz, Manila
JOSEFINA BELMONTE DURAN	----->MEMORIAL DISTRICT HOSP. Tuburan, Ligao, Albay
JOWELL GENERAL HOSPITAL	----->#1 Coral, Magallenes St. Paniqui, Tarlac
JUAN S. ALANO MEMORIAL	----->HOSPITAL Isabela City, Basilan
JUAN M. ALBERTO MEMORIAL	----->HOSPITAL San Andres, Catanduanes
JUAN B. DOSADO MEMORIAL	----->HOSPITAL Sogod, Cebu
JUAN M. DUYAN DISTRICT HOSPITAL	----->Rizal, Kalinga
JUDGE CELESTINO GUERERO	----->MEMORIAL HOSPITAL Sta. Maria, Ilocos Sur
JULIO CARDINAL ROSALES	----->MEMORIAL HOSPITAL Dalaguete, Cebu
JUSTICE CALIXTO O. ZALDIVAR	----->MEMORIAL HOSPITAL (formerly Gov. Leandro Fullon District Hospital) Pandan, Antique
JUSTICE JOSE ABAD SANTOS	----->MOTHER AND CHILD HOSPITAL Binondo, Manila
KC CALDERON HOSPITAL	----->5001 Gen. T. De Leon 120 Mc Arthur Hi-way, Valenzuela City
KABACAN MEDICAL	----->SPECIALIST HOSPITAL Kabacan, North Cotabato
KABACAN POLYMEDIC	----->COOPERATIVE HOSPITAL Osias. Kabacan, North Cotabato
KABANKALAN CITY HOSPITAL	----->Brgy. Tabugon, Kabankalan City Negros Occidental
KABASALAN FATHFINDER HOSPITAL	----->Kabasalan, Sibugay, Zamboanga
KABASALAN GENERAL HOSPITAL	----->Kabasalan, Zamboanga del Sur
KAIROS MATERNITY AND	----->GENERAL HOSPITAL Muzon, San Jose Del Monte City Bulacan
KALAMANSAG MUNICIPAL STATION	----->Kalamansag, Sultan Kudarat
KALINGA DISTRICT HOSPITAL	----->Lubuagan, Kalinga
KALINGA PROVINCIAL HOSPITAL	----->Bulanao, Tabuk, Kalinga
KALUMBOYAN COMMUNITY	----->PRIMARY HOSPITAL Bayawan, Negros Oriental
KANANGA COMMUNITY HOSPITAL	----->Kananga, Northern Leyte
KAPALONG DISTRICT HOSPITAL	----->Kapalong, Davao del Norte
KAPANGAN MEDICARE	----->COMMUNITY HOSPITAL Kapangan, Benguet
KAPATAGAN DISTRICT	----->HOSPITAL Kapatagan, Lanao Del Sur
KASIBU MUNICIPAL HOSPITAL	----->Kasibu, Nueva Viscaya
KAUSWAGAN PROVINCIAL HOSPITAL	----->Kauswagan, Lanao del Norte
KAWIT KALAYAAN HOSPITAL	----->Kawit, Cavite
KAWIT MATERNITY & GENERAL	----->HOSPITAL Kawit, Cavite
KIAMBA DISTRICT HOSPITAL	----->Kiamba, Saranggani
KIDAPAWAN DOCTORS HOSP., INC.	----->Kidapawan City
KIDAPAWAN CITY HOSPITAL	----->Quezon Blvd., Poblacion, Kidapawan City
KIDAPAWAN MEDICAL	----->SPECIALIST CENTER, INC. Sudapin, Kidapawan City
KISOLON EMERGENCY HOSPITAL	----->Kisolon, Sumilao, Bukidnon
KITCHARAO DISTRICT HOSPITAL	----->Kitcharao, Agusan del Norte
KOLAMBUGAN PROVINCIAL HOSPITAL	----->Kolambugan, Lanao del Norte
KUTA MAJ. SANG-AN STATION HOSPITAL	----->Labangan, Zamboanga Del Sur
L.G. CUTAMORA COMMUNITY HOSPITAL	----->Ubay, Bohol
LA PAZ DISTRICT HOSPITAL	----->La Paz, Abra
LA PAZ MEDICARE AND	----->COMMUNITY HOSPITAL San Roque, La Paz, Tarlac
LA PAZ MUNICIPAL HOSPITAL	----->La Paz, Agusan del Sur
LA UNION MEDICAL DIAGNOSTIC	----->CENTER AND HOSPITAL San Fernando City,La Union
LA UNION MEDICAL CENTER	----->(formerly Doña Gregoria Memorial Hospital) Nazareno, Agoo, La Union
LA VINA GENERAL HOSPITAL, INC.	----->M.L. Quezon St., Pob. Valencia City, Bukidnon
LAAK MUNICIPAL HOSPITAL	----->San Vicente, Compustela Valley
LABASON DIST. HOSPITAL	----->(LILOY MEDICARE HOSPITAL) Liloy, Zamboanga del Norte
LABO DISTRICT HOSPITAL	----->Labo, Camarines Norte
LABRADOR MUNICIPAL HOSPITAL	----->Pob. Labrador, Pangasinan
LABUAN PUBLIC HOSPITAL	----->Labuan, Zamboanga City
LADY OF LOURDES HOSPITAL	----->OF CAYBIGA, INC. 15 Gen. Luis St., Caybiga Caloocan City
LAGUNA DOCTORS HOSPITAL	----->P Guevara St., Sta. Cruz, Laguna
LAGUNA HOLY FAMILY HOSPITAL	----->(formerly HOLY FAMILY CLINIC) Sta. Cruz, Laguna
LAGUNA PROVINCIAL HOSPITAL	----->Sta.Cruz, Laguna
LAHOZ CLINIC AND HOSPITAL	----->Vigan, Ilocos Sur
LAKE SEBU MUNICIPAL HOSPITAL	----->Lake Sebu, South Cotabato
LAMBAYONG DISTRICT HOSPITAL	----->Maligaya, Lambayong, Sultan Kudarat
LANAO DEL NORTE	----->PROVINCIAL HOSPITAL Sagadan Baroy, Lanao Del Norte
LANCETA MEDICAL HOSPITAL	----->Imelda Sibugay, Zamboanga
LANDERO CLINIC AND HOSPITAL	----->Surralah, South Cotabato
LANGUYAN MUNICIPAL HOSPITAL	----->Languyan, Tawi-Tawi
LAOAG CITY GENERAL HOSPITAL	----->46 Brgy. Nalbo Laoag City Ilocos Norte
LAOAG PEDIATRIC HOSPITAL	----->Andres Castro St., Laoag City
LAPU-LAPU CITY HOSPITAL	----->Lapu-Lapu City, Cebu
LARIOSA CLINIC & HOSPITAL	----->Surralah, South Cotabato
LAS NIEVES MUNICIPAL HOSPITAL	----->Pob. Las Nieves, Agusan del Norte
LAS PIÑAS CITY MEDICAL CENTER	----->Talon V, Las Piñas City
LAS PIÑAS DOCTORS HOSP INC.	----->CRM Ave., BF Homes, Almanza Las Piñas CIty LAS PIÑAS GEN. HOSPITAL Pulang Lupa I, Las Piñas City
LASAM DISTRICT HOSPITAL	----->Lasam, Cagayan Valley
LAUREL MEMORIAL DISTRICT	----->HOSPITAL Santor Tanauan, Batangas
LAUREL MUNICIPAL HOSPITAL	----->Brgy. Ticub, Laurel, Batangas
LAZI MEDICARE	----->COMMUNITY HOSPITAL Lazi, Siquijor
LEBAK MEDICARE	----->COMMUNITY HOSPITAL Salaman, Lebak, Sultan Kudarat
LEBAK DOCTOR'S HOSPITAL	----->Rizal Avenue, Lebak Sultan Kudarat
LEBAK FAMILY DOCTORS HOSPITAL	----->Pob. Lebak, Sultan Kudarat
LEMERY DOCTORS' MEDICAL CENTER	----->R. Diokno St., Lemery, Batangas
LEON D. HERNANDEZ	----->MEMORIAL HOSPITAL Daet, Camarines Norte
LEPANTO CONSOLIDATED	----->MINING HOSPITAL Makayan, Benguet
LEONA O. LIM MEMORIAL HOSPITAL	----->Valencia, Bohol
LEONCIO GENERAL HOSPITAL	----->Brgy. Pangobilian, Brooke's Point Palawan
LEONCIO UY MEMORIAL	----->HOSPITAL Catarman, Northern Samar
LEYTE BAPTIST HOSPITAL, INC.	----->Hilongos, Leyte
LEYTE PROVINCIAL HOSPITAL	----->Candahug, Palo, Northern Leyte
LIANGA DISTRICT HOSPITAL	----->Lianga, Surigao del Sur
LIANKO'S MEDICAL CLINIC	----->Malinao, Albay
LIAO'S CLINIC AND HOSPITAL	----->Sawang, Guindulman, Bohol
LIBMANAN DISTRICT HOSPITAL	----->Libmanan, Camarines Sur
LIDE PASAR HOSPITAL	----->Isabel, Leyte
LILOAN COMMUNITY HOSPITAL	----->Liloan, Southern Leyte
LILOY INTEGRATED HEALTH	----->DISTRICT HOSPITAL Liloy, Zamboanga City
LIM COMMUNITY HOSPITAL	----->Jagna, Bohol
LINGIG COMMUNITY HOSPITAL	----->Lingig, Surigao del Sur
LIPA CITY DISTRICT HOSPITAL	----->Lipa City, Batangas
LIPA DOCTOR'S HOSPITAL	----->Rizal St., Lipa City
LIPA MEDIX MEDICAL CENTER	----->Balintawak Lipa City
LIPUNAN HOSPITAL, INC.	----->Gingoog City, Cagayan de Oro City
LITTLE ANGELS MEDICAL	----->HOSPITAL Elustre Ave., Lemery, Batangas
LIWAG MEDICAL CLINIC, INC.	----->A Mayo St., Pob ll, Tiaong, Quezon
LLANOS MEDICAL CLINIC	----->Digos City, Davao del Sur
LLORENTE MUNICIPAL HOSPITAL	----->Llorente, Eastern Samar
LOBO MUNICIPAL HOSPITAL	----->Fabrica Lobo, Batangas
LOPEZ DISTRICT FARMER'S HOSPITAL	----->Sagay City, Western Visayas
LOPEZ FAMILY CLINIC AND HOSPITAL	----->Mangatarem, Pangasinan
LOPEZ ST. JUDE GENERAL	----->HOSPITAL CORP Real St., Lopez, Quezon
LORETO DISTRICT HOSPITAL	----->Loreto, Surigao del Norte
LORETO MUNICIPAL HOSPITAL	----->Loreto, Agusan del Sur
LORMA MEDICAL CENTER	----->Carlatan, San Fernado City La Union
LORENZO D. ZAYCO DISTRICT HOSPITAL	----->Kabankalan City Negros Occidental
LOS BAÑOS DOCTORS HOSPITAL	----->Los Baños, Laguna
LOURDES HOSPITAL	----->Iriga City
LT. TIDANG MEMORIAL HOSPITAL	----->Kayapa, Nueva Viscaya
LU CLINIC AND HOSPITAL	----->National Highway, Tacurong City Sultan Kudarat
LUBANG DISTRICT HOSPITAL	----->Lubang, Occidental Mindoro
LUCAS-PAGUILA MEDICAL CLINIC	----->Magsaysay, Alicia, Isabela
LUCBAN MMG HOSPITAL	----->(formerly Dr. Francisco Faller Memorial Hosp.) Lucban, Quezon
LUCENA MMG GENERAL HOSPITAL	----->Ibabang Dupay Red V, Lucena City, Quezon
LUCENA UNITED DOCTORS HOSPITAL	----->Brgy. Isabang, Lucena City, Quezon
LUDOVICE GENERAL HOSPITAL	----->Daraga, Albay
LUIS HORA MEMORIAL &	----->REGIONAL HOSPITAL Bauko, Mt. Province
LUIS VILLA MEMORIAL HOSPITAL	----->Pob. 3 Clarin, Misamis Occidental
LUISIANA DISTRICT HOSPITAL	----->Luisiana, Laguna
LUMBIS - RANCES GEN. HOSP.	----->Oas, Albay
LUNA GOCO MEDICAL CLINIC	----->Calapan City, Oriental Mindoro
LUNG CENTER OF THE PHILS.	----->Quezon Avenue, Quezon City
LUPON DISTRICT HOSPITAL	----->Lupon, Davao Oriental
LUTHERAN MEDICAL MISSION	----->AND FOUNDATION INC. (former Lutheran Hospital) Baguis, Benguet
LUUK DISTRICT HOSPITAL	----->Luuk, Sulu
LUZ-SIKATUNA COMMUNITY	----->PRIMARY HOSPITAL Guihulngan, Negros Oriental
LUZON MEDICAL CENTER	----->Tapuac District, Dagupan City
LYCEUM OF APARRI HOSPITAL	----->Macanaya, Aparri, Cagayan
M.V. GALLEGO CABANATUAN	----->CITY GENERAL HOSPITAL Maharlika Rd., Cabanatuan City
M. NAPEÑAS MEDICAL CLINIC	----->Sta. Rita, Concepcion, Tarlac
M.V. SANTIAGO MEDICAL CENTER	----->Brgy. De Ocampo Trece Martirez, Cavite
M. SIMON MEDICAL CLINIC	----->Ipil, Zamboanga Sibugay
MCU-FDT MEDICAL	----->FOUNDATION HOSPITAL Edsa, Caloocan City
MMG HOSPITAL AND HEALTH	----->SERVICES COOPERATIVE OF ORIENTAL MINDORO Tawiran, Calapan City, Oriental Mindoro
MMG HOSPITAL AND HEALTH	----->SERVICES COOP. PUERTO PRINCESA CHAPTER #14 Taft St., Puerto Princesa City
MPI-MEDICAL CENTER MUNTINLUPA	----->38 Nat'l Rd. Putatan, Muntinlupa City
MA. ESTRELLA GENERAL HOSPITAL	----->Tawiran Calapan City, Oriental Mindoro
MA. LOURDES MATERNITY HOSPITAL	----->Chino Roces Ave., cor. Solchuaga Makati City
MAASIM MUNICIPAL HOSPITAL	----->Maasim, Sarangani
MABALACAT DISTRICT HOSPITAL	----->Mabalacat, Pampanga
MABINAY MEDICARE	----->CUMMUNITY HOSPITAL Mabinay, NEgros Oriental
MACABEBE DISTRICT HOSPITAL	----->Macabebe, Pampanga
MACTAN DOCTOR'S HOSPITAL	----->Basak, Lapu-Lapu City
MADDELA MUNICIPAL HOSPITAL	----->Maddela, Quirino
MADONNA AND CHILD HOSPITAL	----->Carmen, Cagayan de Oro City
MADONNA GENERAL HOSPITAL	----->Balayan, Batangas
MADONNA GENERAL	----->HOSPITAL, INC. Lanao St., Kidapawan City
MADRID DISTRICT HOSPITAL	----->Madrid, Surigao del Sur
MAGALLANES MEDICARE	----->COMMUNITY HOSPITAL Magallanes, Sorsogon
MAGTABOG GENERAL HOSPITAL	----->(former Gonzales - Advincula Med Clinic) Sta Maria, Davao Del Sur
MAGPOC MATERNITY	----->HOSPITAL, INC. Guiguinto, Bulacan
MAGRINA CLINIC & HOSPITAL	----->Buluan, Maguindanao
MAGSAYSAY MEMORIAL	----->DISTRICT HOSPITAL Lopez, Quezon
MAGSINGAL DISTRICT HOSPITAL	----->Magsingal, Ilocos Sur
MAGUINDANAO PROVINCIAL	----->HOSPITAL Shariff Aguak, Maguindanao
MAHAL NA VIRGEN MARIA	----->STO. ROSARIO DISTRICT HOSPITAL (formerly M.V.M. Sto. Rosario Municipal Hospital) Rosario, Batangas
MAHAYAG DISTRICT HOSPITAL	----->Mahayag, Zamboanga del Sur
MAHESECO MULTI-PURPOSE	----->COOPERATIVE Lakandula St., Poblacion Mariveles, Bataan
MAINIT MEDICARE COMMUNITY	----->HOSPITAL Mainit, Surigao del Norte
MAITUM MUNICIPAL HOSPITAL	----->Maitum, Sarangani
MAJAYJAY MEDICARE HOSPITAL	----->Majayjay, Laguna
MAJOR DANILO ATIENZA	----->AIR BASE HOSPITAL Sangley Point, Cavite
MAKATI MEDICAL CENTER	----->2 Amorsolo St., Makati City
MAKILALA MEDICAL SPECIALIST	----->HOSPITAL, INC. Makilala, North Cotabato
MALASIQUI MUNICIPAL HOSPITAL	----->Malasiqui, Pangasinan
MALATE MEDICAL CLINIC	----->Saypon Highway, Toril Davao City
MALAY MUNICIPAL HOSPITAL	----->Malay, Aklan
MALAYBALAY MEDICAL HOSPITAL	----->Fortichst Brgy.Malaybalay City Bukidnon
MALAYBALAY POLYMEDIC	----->GENERAL HOSPITAL Fortichst, Brgy. Malaybalay City Bukidnon
MALIMONO DISTRICT HOSPITAL	----->Malimono, Surigao del Norte
MALIPAYON DISTRICT HOSPITAL	----->Corcuera, Romblon
MALITA DISTRICT HOSPITAL	----->Malita, Davao del Sur
MALOLOS MATERNITY	----->HOSPITAL & EYE CENTER McArthur H-way, Malolos, Bulacan
MALOLOS SAN ILDEFONSO	----->COUNTY HOSPITAL Brgy. Canalate, Malolos, Bulacan
MALTA MEDICAL CENTER	----->Toril, Davao City
MALUNGON MUNICIPAL HOSPITAL	----->Malungon, Sarangani
MAMBUSAO DISTRICT HOSPITAL	----->Mambusao, Capiz
MANABAT MATERNITY AND	----->GENERAL HOSPITAL San Matias, Sto. Tomas, Pampanga
MANANGAN CLINIC AND HOSPITAL	----->Buluan, Maguindanao
MANANGO HOSPITAL	----->Nat'l. Hi-way, San Antonio Alicia, Isabela
MANAOAG COMMUNITY HOSPITAL	----->Manaoag, Pangasinan
MANAY DISTRICT HOSPITAL	----->Sta. Maria, Manay Davao Oriental
MANDALUYONG CITY	----->MEDICAL CENTER Boni Avenue, Mandaluyong City
MANDAON MEDICARE	----->COMMUNITY HOSPITAL Mandaon, Masbate
MANGATAREM DISTRICT HOSP.	----->Mangatarem, Pangasinan
MANILA ADVENTIST MEDICAL	----->CENTER AND SCHOOL OF MEDICAL ARTS INC. 1975Donada St.,Pasay City
MANILA DOCTOR'S HOSPITAL	----->667 UN Avenue, Ermita, Manila
MANILA EAST MEDICAL CENTER	----->Manila East Rd., Bgy. Dolores Taytay, Rizal
MANILA NAVAL HOSPITAL	----->Fort Bonifacio, Taguig City
MANITO MUNICIPAL HOSPITAL	----->Manito, Albay
MANSALAY MEDICARE HOSPITAL	----->Mansalay, Oriental Mindoro
MANUEL HOSPITAL	----->Lanao St., Kidapawan City
MANUEL A. ROXAS DISTRICT HOSPITAL	----->Roxas, Isabela
MANUEL J. SANTOS HOSPITAL	----->Montillana Blvd., Butuan City
MANUKAN MEDICARE	----->COMMUNITYHOSPITAL Manukan, Zamboanga del Norte
MAPANDAN MUNICIPAL HOSPITAL	----->Mapandan, Pangasinan
MAPANDI MEMORIAL HOSPITAL	----->048 Buanda Boulevard Saduc Marawi City, Lanao Del Sur
MARAAT MEDICAL HOSPITAL	----->Publacion Quezon, Bukidnon
MARAGUSAN MUNICIPAL	----->HOSPITAL Maragusan, Compostela Valley
MARAMAG MEDICLINIC AND	----->LABORATORY (formerly MARAMAG MEDICAL CLINIC) Maramag, Bukidnon
MARANDING COMMUNITY HOSPITAL	----->Fernan Subd., Maranding Lala, Lanao Del Norte
MARCELLO HOSPITAL	----->237 M. Ponce St., Baliuag Bulacan
MARCELLO-PADILLA CHILDREN'S	----->AND MEDICAL HOSPITAL Banga I. Plaridel, Bulacan
MARGOSA TUBIG REGIONAL	----->HOSPITAL Margosatubig, Zamboanga del Sur
MARIA L. ELEAZAR MEMORIAL	----->DISITRICT HOSPITAL (formerly Tagkawayan District Hosp.) Tagkawayan, Quezon
MARIA LOURDES MATERNITY	----->HOSPITAL Don Chino Roces Ave., Makati City
MARIA REYNA HOSPITAL	----->Cagayan de Oro City
MARIAN HOSPITAL OF STA. ROSA, INC.	----->Brgy. Tagapo, Sta. Rosa City, Laguna
MARIANO JESUS CUENCO	----->MEMORIAL HOSPITAL Malabuyoc, Cebu City
MARIANO MARCOS MEMORIAL	----->HOSPITAL & MEDICAL CENTER Batac, Ilocos Norte
MARIHATAG DISTRICT HOSPITAL	----->Marihatag, Surigao del Sur
MARIKINA ST. VINCENT	----->GENERALHOSPITAL, INC. Concepcion, Marikina City
MARIKINA VALLEY MEDICAL CENTER	----->Sumulong Hi-way Cor., Aguinaldo Ave., Marikina City
MARKVIM HOSPITAL	----->Almar Subd., Kalookan City
MARIBOJOC COMMUNITY	----->HOSPITAL Maribojoc, Bohol
MARSMAN ESTATE	----->PLANTATION, INC. (MEPI) MEDICAL CLINIC / HOSPITAL Sto. Tomas, Davao del Norte
MARTIN MARASIGAN MEMORIAL	----->HOSPITAL (formerly Cuenca Medicare Community Hosp.) Cuenca, Batangas
MARTINEZ MEMORIAL HOSPITAL	----->198 A. Mabini St., Maypajo, Caloocan City
MARY CHILES GENERAL HOSPITAL	----->667 Gastambide St., Sampaloc, Manila
MARY IMMACULATE	----->MATERNITY HOSPITAL Sto. Rosario, Malolos, Bulacan
MARY IMMACULATE HOSPITAL	----->E. Rodriguez Ave., Bagong Ilog, Pasig City
MARY JOHNSTON HOSPITAL	----->1221Juan Nolasco St. Tondo, Manila
MARY MEDIATRIX MEDICAL	----->CENTER Lipa City, Batangas
MARY THE QUEEN MATERNITYAND	----->GEN. HOSPITAL FOUNDATION INC. Sto. Niño, Plaridel, Bulacan
MASBATE DOCTORS HOSPITAL	----->Rosero St., Masbate City
MASBATE PROVINCIAL HOSPITAL	----->Masbate, Masbate
MASONGSONG CLINIC	----->Digos City, Davao del Sur
MATAAS NA KAHOY COMMUNITY	----->HOSPITAL Pob., Mataas na Kahoy, Batangas
MATEO'S DIAGNOSTIC CLINIC	----->AND GENERAL HOSPITAL, INC. Bagbaguin, Sta. Maria, Bulacan
MATIAS CLINIC AND HOSPITAL	----->National Highway, Isulan Isulan, Sultan Kudarat
MATILDE A. OLIVAS DISTRICT	----->HOSPITAL Camalaniugan, Cagayan
MATNOG MEDICARE	----->COMMUNITY HOSPITAL Matnog, Sorsogon
MATUTES MEDICAL CLINIC	----->AND HOSPITAL Sto. Tomas, Davao del Norte
MAUBAN DISTRICT HOSPITAL	----->Mauban, Quezon
MAWAB MEDICAL CLINIC AND	----->HOSPITAL Mawab, Compostela Valley
MAYOR HILARION A. RAMIRO SR.	----->REGIONAL TRAINING AND TEACHING HOSPITAL Maningcal, Ozamis City
MAYOR JOAQUIN G. MACIAS	----->MEMORIAL HOSPITAL Sindangan, Zamboanga del Norte
MAYOYAO DISTRICT HOSPITAL	----->Mayoyao, Ifugao
MCPC ST. THERESE OF USIEUX	----->DOCTORS HOSPITAL Maybunga, Pasig City
MEDICAL CENTER OF DIGOS	----->COOP. HOSPITAL Digos, Davao del Sur
MEDICAL CENTER IMUS	----->Imus, Cavite
MEDICAL CENTER MANILA	----->1122 Gen. Luna, Ermita, Manila
MEDICAL CENTER PARAÑAQUE, INC.	----->Dr. A. Santos Ave. Sucat Road, Parañaque City
MEDICAL CENTRUM DAGUPAN	----->A. B. Fernandez East, Dagupan City
MEDICAL MISSION GROUP	----->HOSPITAL & HEALTH SERVICES COOP - BOHOL Tagbilaran City, Bohol
MEDICAL MISSION GROUP	----->HOSPITAL & HEALTH SERVICES COOPERATIVE OF DAVAO CITY Leon Garcia St., Sta Ana Davao City
MEDICAL MISSION GROUP	----->HOSPITAL & HEALTH SERVICES COOP-NUEVA VIZCAYA Solano, Nueva Vizcaya
MEDICAL MISSION GROUP HOSPITAL	----->AND HEALTH SERVICES COOPERATIVE OF TACURONG Tacurong City, Sultan Kudarat
MEDICAL MISSION GROUP HOSPITAL	----->AND HEALTH SERVICES OF TAGUM Visayan Village, Tagum City, Davao del Norte
MEDICARE COMMUNITY	----->HOSPITAL-JIMENEZ Poblacion Jimenez, Misamis Occidnetal
MEDIDAS MEDICAL CLINIC	----->Roxas St., Valencia City, Bukidnon 10
MEDINA GENERAL HOSPITAL	----->Ozamis City, Misamis Occidental
MELVERY MATERNITY HOSPITAL	----->Tabang, Plaridel, Bulacan
MENDOZA GENERAL	----->HOSPITAL Sta. Maria, Bulacan
MERCEDES MEDICAL CENTER	----->(formerly Pamana Medical Center) Sto. Entierro St., Angeles City
MERCY CLINIC AND HOSPITAL	----->Cardinal Santos St., Sto. Nino Guagua, Pampanga
MERCY COMMUNITY	----->HOSPITAL, INC. Kamague, Iligan City
METRO LEMERY MED. CENTER	----->Palanas, Lemery, Batangas
METRO LIPA MEDICAL CENTER	----->J.P. Laurel Highway Marawoy, Lipa City
METRO PAGADIAN HOSPITAL, INC.	----->V. Sagun St., Lumbia Dist. Pagadian City, Zamboanga Del Sur
METRO RIZAL DOCTORS HOSPITAL	----->San Roque, Cainta, Rizal
METRO SOUTH MEDICAL CENTER	----->Molino IV, Bacoor, Cavite
METRO VIGAN COOPERATIVE HOSPITAL	----->Roxas Dike (Bantay) Vigan,Ilocos Sur
METROPOLITAN MEDICAL	----->CENTER-NASUGBU BRANCH Km. 72 Brgy. Kaylaway Sitio Batulao, Nasugbu, Batangas
METROPOLITAN MEDICAL CENTER	----->(formerly Metropolitan Hospital) 1357 G. Masangkay St. Tondo, Manila
MEYCAUAYAN DOCTORS	----->HOSPITAL INC. Banga, Meycauayan, Bulacan
MIDSALIP INFIRMARY HOSPITAL	----->Midsalip, Zamboanga Del Sur
MIDSAYAP COMMUNITY	----->DOCTOR'S HOSPITAL Midsayap, North Cotabato
MIDSAYAP DIAGNOSTIC	----->CENTER AND HOSPITAL Pob. 8 Quezon Ave. Midsayap, North Cotabato
MIGUEL CLINIC	----->Estacion, Paniqui, Tarlac
MILAGROS DISTRICT HOSPITAL	----->Cabagan, Isabela
MINA DE ORO GENERAL	----->HOSPITAL Victoria, Oriental Mindroro
MINDANAO SPECIALIST HOSPITAL	----->FOUNDATION, INC. Panggao Saduc, Marawi City Lanao Del Sur
MINDANAO CENTRAL SANITARIUM	----->Pasobolong, Zamboanga City
MINDANAO SANITARIUM AND HOSPITAL	----->Tibanga, Iligan City Lanao del Norte
MINGLANILLA DISTRICT HOSPITAL	----->Minglanilla, Cebu
MIRACULOUS MEDAL EMERGENCY	----->MEDICAL CLINIC Singalong, Malate, Manila
MIRANDA FAMILY HOSPITAL	----->Km. I, Surigao City, Surigao del Norte
MISAMIS COMMUNITY	----->HOSPITAL, INC. Tinago, Ozamis City, Misamis Occidental
MISAMIS OCCIDENTAL	----->PROVINCIAL HOSPITAL (IPHO) Oroquieta City, Misamis Occ.
MISAMIS ORIENTAL PROVINCIAL	----->HOSPITAL-CLAVERIA Poblacion, Claveria Misamis Oriental
MISAMIS ORIENTAL PROVINCIAL	----->HOSPITAL-BALINGASAG Poblacion, Balingasag Misamis Oriental
MISAMIS ORIENTAL PROVINCIAL	----->HOSPITAL-GINGOOG Doña Graciana St., Gingoog City
MISAMIS ORIENTAL PROVINCIAL	----->HOSPITAL-INITAO Codilla St., Poblacion, Initao
MISAMIS ORIENTAL PROVINCIAL	----->HOSPITAL-MAGSAYSAY Cabubuhan, Magsaysay Misamis Oriental
MISAMIS ORIENTAL PROVINCIAL	----->HOSPITAL-MANTICAO Poblacion, Manticao, MIsamis Oriental
MISAMIS ORIENTAL PROVINCIAL	----->HOSPITAL-TALISAYAN Poblacion, Talisayan Misamis Oriental
MISAMIS UNIVERSITY MEDICAL CENTER	----->Bagakay, Ozamis City, Misamis Occidental
MISSION HOSPITAL	----->Km. 17, Ortigas Ave., Ext. Rosario, Pasig City
M'LANG DISTRICT HOSPITAL	----->Kabacan, North Cotabato
M'LANG DOCTOR'S HOSPITAL, INC.	----->M. H. del Pilar St., M'lang. North Cotabato City
MOISES ESPINOSA SR. MEMORIAL	----->MUNICIPAL HOSPITAL Dimasalang, Masbate
MOLINO DOCTORS HOSPITAL	----->Bacoor, Cavite
MORONG DOCTORS HOSPITAL	----->Morong, Rizal
MOTHER AND CHILD HOSPITAL	----->75 Kessing St., Olongapo City Zambales
MOTHER OF MERCY HOSPITAL	----->Tacloban City, Eastern Samar
MOTHER OF PERPETUAL HELP HOSPITAL	----->Sto. Entierro, Angeles City
MOTHER TERESA OF CALCUTTA	----->MEDICAL CENTER Maimpis, San Fernando City, Pampanga
MT. CARMEL DIOCESAN	----->GENERAL HOSPITAL Allarey Extension, Lucena City
MT. CARMEL HOSPITAL MEDICAL	----->CENTER OF BULACAN, CORP Bunlo, Bocaue, Bulacan
MT. OF BLESSINGS HOSPITAL	----->Libungan, North Cotabato
MUÑOZ CLINIC	----->San Nicolas, San Fernando City Pampanga
N. L. VILLA MEMORIAL MEDICAL	----->CENTER Lipa City
N. MED-CARE HOSPITAL	----->143 A. Mabini, Burgos Rodriguez, Rizal
NABILOG COMMUNITY	----->PRIMARY HOSPITAL Tayasan, Negros Oriental
NABUNTURAN DOCTORS HOSPITAL,	----->INC. (former Flores Medical Clinic) Nabunturan, Campostela Valley
NAGA CITY HOSPITAL	----->Penafrancia Avenue Naga City
NAGCARLAN DISTRICT	----->HOSPITAL Nagcarlan, Laguna
NAGUILIAN DISTRICT	----->HOSPITAL Naguilian, La Union
NAIC DOCTORS HOSPITAL	----->Daang Makina, Naic, Cavite
NAIC MEDICARE HOSPITAL	----->Naic, Cavite
NAQUITQUITAN MEDICAL	----->CLINIC AND HOSPITAL Carmen, North Cotabato
NARRA MUNICIPAL HOSPITAL	----->Narra, Palawan
NASIPIT DISTRICT HOSPITAL	----->Nasipit, Agusan del Norte
NATIONAL CENTER FOR	----->MENTAL HEALTH 9 Febrero Street Mandaluyong City
NATIONAL CHILDREN'S HOSPITAL	----->266 E. Rodriguez Sr. Blvd. Quezon City
TRANSPLANT INSTITUTE	----->East Avenue, Quezon City
NATONIN COMMUNITY HOSPITAL	----->Natonin, Mt. Province
NAUJAN MUNICIPAL HOSPITAL	----->Santiago, Naujan Oriental Mindoro
NAZARENUS COLLEGE	----->FOUNDATION HOSPITAL Saluysoy, Bulacan
NAZARETH GENERAL HOSPITAL, INC.	----->203 Perez St., Dagupan City
NEGROS ORIENTAL PROVINCIAL HOSPITAL	----->Piapi, Dumaguete City Negros Occidental
NEOPOLITAN MEDICAL MATERNITY	----->CHILDREN'S & LYING-IN CLINIC INC. Flordeliza Bldg., km 23 Quirino Hi-way, Lagro Novaliches, Quezon City
NEW BAYUGAN MEDICAL HOSPITAL	----->Bayugan, Agusan del Sur
NEW BILIBID PRISONS HOSPITAL	----->N.B.P. Reservation Muntinlupa City
NEW LUCENA POLYTECHNIC COLLEGE	----->MEDICAL CLINIC AND HOSPITAL New Lucena, Iloilo
NEW SAMARITAN MEDICAL	----->AND PEDIATRIC CLINIC San Mateo, Isabela
NEW SINAI MDI HOSPITAL	----->Nat'l. Highway, Tagapo Sta. Rosa, Laguna
NODADO GENERAL HOSPITAL	----->Bigte, Norzagaray, Bulacan
NODADO GENERAL HOSPITAL	----->Novaliches, Quezon City
NODADO GENERAL HOSPITAL	----->Area A, Camarin, Caloocan City
NORALA DISTRICT HOSPITAL	----->Norala, South Cotabato
NORTH CALOOCAN	----->DOCTORS HOSPITAL Banker's Vill 2, Quirino Hi-way Kaloocan City
NORTHERN CAGAYAN	----->DISTRICT HOSPITAL Sanchez Mira, Cagayan Valley
NORTHERN DOCTORS	----->GENERAL HOSPITAL Laoag City, Ilocos Norte
NORTHERN LA UNION MATERNITY	----->& CHILDREN'S HOSPITAL Balaoan, La Union
NORTHERN MINDANAO	----->MEDICAL CENTER Cagayan de Oro City
NORTHERN SAMAR PROVINCIAL	----->HOSPITAL Catarman, Northern Samar
NORTHWESTERN LEYTE	----->DISTRICT HOSPITAL Calubian, Northern Leyte
NORZAGARAY MUNICIPAL HOSPITAL	----->Pob. Norzagaray, Bulacan
NOTRE DAME HOSPITAL AND	----->SCHOOL OF MIDWIFERY, INC. Rosary Heights, Cotabato City
NOTRE DAME OF DE CHARTERS	----->HOSPITAL General Luna, Baguio City
NOVALICHES DISTRICT HOSPITAL	----->Quirino Hi-way, San Bartolome Novaliches, Quezon City
NOVALICHES GENERAL HOSPITAL	----->Quirino Highway, Gulod Novaliches, Quezon City
NUESTRA SEÑORA DE PIAT	----->DISTRICT HOSPITAL Maquilling Piat, Cagayan Valley
NUESTRO ESPIRITU MEDICALSURGICAL	----->AND DIAGNOSTIC CENTER Bongabong, Oriental Mindoro
NUEVA ECIJA DOCTOR'S HOSP. INC.	----->Km. 111 Maharlika High Way Cabanatuan City Nueva Ecija
NUEVA ECIJA GOOD SAMARITAN	----->GEN. HOSP. INC. Burgos Avenue, Cabanatuan City Nueva Ecija
NUEVA ECIJA GOOD SAMARITAN	----->GEN. HOSP. INC. (EXT.) Bucana, Gapan, Nueva Ecija
NUEVA VALENCIA DISTRICT HOSPITAL	----->Lanipe, Nueva Valencia Guimaras, Sub Province
NUEVA VISCAYA PROVINCIAL HOSPITAL	----->Bambang, Nueva Viscaya
OCAMPO MUNICIPAL HOSPITAL	----->Ocampo, Camarines Sur
OCCIDENTAL MINDORO	----->PROVINCIAL HOSPITAL Mamburao, Occ. Mindoro
OFELIA MENDOZA MATERNITY	----->& GENERAL HOSPITAL Mojon, Malolos, Bulacan
OLIVAREZ GENERAL HOSPITAL	----->Dr. A. Santos Ave., Sucat Road Parañaque City
OLUTANGA MUNICIPAL HOSPITAL	----->Sibugay, Zamboanga del Sur
ORANI DISTRICT HOSPITAL	----->Orani, Bataan
ORAS DISTRICT HOSPITAL	----->Oras, Eastern Samar
ORDOÑEZ ADULT AND	----->CHILDREN'S CLINIC Pugaro, Balungao, Pangasinan
ORDOÑEZ MEDICAL HOSPITAL	----->Villasis, Pangasinan
ORIENTAL MINDORO	----->PROVINCIAL HOSPITAL Calapan City, Oriental Mindoro
ORION ST. MICHAEL HOSPITAL	----->Calle JP Rizal, Wakas, Orion, Bataan
ORMOC DISTRICT HOSPITAL	----->Ormoc City, Northern Leyte
ORMOC MATERNITY AND	----->CHILDREN'S HOSPITAL Ormoc City
OROQUIETA COMMUNITY	----->HOSPITAL, INC. J.P. Quijano St., Oroquieta City MIsamis Occidental
OSLOB DISTRICT HOSPITAL	----->Oslob, Cebu City
OSPA FARMERS MEDICAL CENTER	----->Ormoc City
OSPITAL NING ANGELES	----->Visitacion St. cor Pampang Rd. Brgy. Pampang, Angeles City
OSPITAL NING CAPAS	----->Capas, Tarlac
OSPITAL NG BARAS	----->Baras, Rizal
OSPITAL NG BIÑAN	----->Canlalay, Biñan, Laguna
OSPITAL NG CABUYAO	----->Brgy. Tres, Cabuyao, Laguna
OSPITAL NG GUIGUINTO	----->Tabe, Guiguinto, Bulacan
OSPITAL NG KABATAAN	----->NG DIPOLOG INC. Dipolog City
OSPITAL NG LUNGSOD NG	----->SAN JOSE DEL MONTE Sapang Palay, San Jose Del Monte, Bulacan
OSPITAL NG MAKATI	----->Malugay Street, Makati City
OSPITAL NG MAKATI	----->ACUTE CARE CENTER Bel-Air, Makati City
OSPITAL NG MAYNILA	----->MEDICAL CENTER Pres. Quirino Ave., cor. Roxas Blvd., Manila
OSPITAL NG MUNTINLUPA	----->Alabang, Muntinlupa
OSPITAL NG PALAWAN	----->220 Malvar St., Puerto Princesa City, Palawan
OSPITAL NG SAMPALOC	----->677 Geronimo cor. Carola St. Sampaloc, Manila
OSPITAL NG STA. CRUZ	----->Sta. Cruz, Zambales
OSPITAL NG TAGAYTAY	----->Bacolod St.,Kaybagal Tagaytay City
OSPITAL NG TONDO	----->J. Abad Santos, Tondo, Manila
OUR LADY OF CAYSASAY	----->MEDICAL CENTER V. Illustre St.,Lemery, Batangas
OUR LADY OF FATIMA HOSPITAL	----->Panganiban, Catanduanes
OUR LADY OF FATIMA MEDICAL	----->CLINIC & HOSPITAL 18-A Mabini St., Laoag City
OUR LADY OF GRACE HOSPITAL	----->8th Avenue cor. F. Roxas St. Grace Park, Caloocan City
OUR LADY OF GUADALUPE HOSPITAL	----->(former Cero's Medical Clinic) Gen. McArthur, Eastern Samar
OUR LADY OF HOPE MEDICAL	----->CLINIC AND HOSPITAL Esperanza, Sultan Kudarat
OUR LADY OF LOURDES HOSPITAL	----->Vinzons Avenue, Daet Camarines Norte
OUR LADY OF LOURDES	----->HOSPITAL, INC. 46 P. Sanchez St. Sta. Mesa, Manila
OUR LADY OF LOURDES	----->INTERNATIONAL MEDICAL CENTER Bo. Baretto, Olongapo City, Zambales
OUR LADY OF MEDIATRIX HOSPITAL	----->San Jose, Iriga City Camarines Sur
OUR LADY OF MERCY	----->GENERAL HOSPITAL, CO. Dona Remedios Trinidad Highway Brgy. Longos, Pulilan, Bulacan
OUR LADY OF MT. CARMEL	----->MEDICAL CENTER Saguin, San Fernando City, Pampanga
OUR LADY OF MT. CARMEL	----->MEDICAL CENTER-CLARK Ninoy Aquino Ave., SBFZ, Angeles City
OUR LADY OF PEACE HOPSITAL	----->Coastal Road, Paranaque City
OUR LADY OF PIAT POLYCLINIC	----->AND HOSPITAL Biñan, Laguna
OUR LADY OF PORCIUNCULA	----->HOSPITAL INC. Magsaysay Blvd. cor. East Awang Calbayog, Eastern Samar
OUR LADY OF PURIFICATION	----->DOCTORS HOSPITAL Binmaley, Pangasinan
OUR LADY OF ROSARY	----->HOSPITAL INC. Talag St., Macabebe, Pampanga
OUR LADY OF RULE MATERNITY	----->AND GENERAL HOSPITAL Pajo, Lapu-Lapu City
OUR LADY OF THE PILLAR	----->MEDICAL CENTER Tamsire Ave., Imus, Cavite
OUR LADY OF THE WAY	----->MEDICAL & PEDIATRICS CLINIC Magallanes, Cavite
OUR SAVIOR HOSPITAL., INC.	----->Gen. Trias Drive, Rosario, Cavite
OVERSEAS CONTRACT	----->WORKERS GENERAL HOSPITAL 39 Tandang Sora Avenue Culiat Street, Quezon City
OZAMIS CITY ST. JOSEPH	----->GENERAL HOSPITAL Washington St., Ozamis City
P. GONZALES MEMORIAL	----->HOSPITAL, INC. Malanday, Marikina City
PLT COLLEGE, INC - LUIS TIAM	----->MEMORIAL HOSPITAL Bascaran,Solano, Nueva Vizcaya
PACENCIA GONZALES MEMORIAL	----->EMERGENCY HOSPITAL 48 Del Pilar, Tagudin, Ilocos Sur
PACUAN COMMUNITY	----->PRIMARY HOSPITAL La Libertad, Negros Oriental
PADRE BURGOS	----->COMMUNITY HOSPITAL Padre Burgos, Southern Leyte
PADRIGUILAN'S MATERNITY	----->AND MEDICAL CLINIC McArthur Highway, Bancal Meycauayan, Bulacan
PADRON -TIBIO MEDICAL CLINIC	----->Pasuquin, San Jose Aurora, Isabela
PAETE GENERAL HOSPITAL	----->JP Rizal St,, Paete, Laguna
PAGADIAN CITY MEDICAL HOSPITAL	----->Cabrera St., Pagadian City, Zamboanga Peninsula
PAGADIAN DOCTOR'S HOSPITAL	----->Lumbia Dist., Pagadian City
PAGAMUTANG BAYAN NG CARMONA	----->Carmona, Cavite
PAGAMUTANG BAYAN NG MALABON	----->Maya-Maya St., cor Dagatan Ave. Kaunlaran Vill. Malabon
PAGAMUTANG BAYAN NG CARMONA	----->Carmona, Cavite
PAGAMUTANG PANGMASA NG LAGUNA	----->Maitim Bay, Laguna
PAG-ASA HOSPITAL	----->National Road, Sitio Sapa Brgy. Pag-asa, Binangonan, Rizal
PAGSANJAN MEDICAL CLINIC INC.	----->Pagsanjan, Laguna
PAHILAN FAMILY CLINIC	----->Don Carlos, Bukidnon
PALANAN STATION HOSPITAL	----->Palanan, Isabela
PALAWAN ADVENTIST HOSPITAL	----->San Pedro, Pto. Princesa City, Palawan
PALAWAN BAPTIST HOSPITAL	----->Roxas, Palawan
PALMA-MALALUAN HOSPITAL	----->J. Magtibay, Rosario, Batangas
PALUAN MEDICARE	----->COMMUNITY HOSPITAL Paluan, Occidental Mindoro
PAMANA MEDICAL CENTER	----->(formerly Pamana Golden Care Foundation, Inc.) Calamba City, Laguna
PAMPANGA EENT AND	----->GENERAL HOSPITAL 17 San Nicolas, San Fernando City, Pampanga
PAMPANGA MEDICAL SPECIALIST	----->HOSPITAL AND PHARMACY San Antonio, Guagua, Pampanga
PAMPLONA MEDICAL CLINIC	----->46 Real St., Pamplona Las Piñas City
PANABO POLYMEDIC HOSPITAL	----->Panabo, Davao del Norte
PANAYAMAN GENERAL HOSPLITAL	----->Bula, Gen. Santos City
PANDAN DISTRICT HOSPITAL	----->Pandan, Catanduanes
PANGASINAN CENTER FOR	----->FAMILY MEDICINE Tapuac District Dagupan City, Pangasinan
PANGASINAN DOCTORS HOSPITAL	----->Rizal Ave., San Carlos City Pangasinan
PANGASINAN MEDICAL	----->CENTER, INC. Nable St., Dagupan City
PANGUTARAN DISTRICT HOSPITAL	----->Pangutaran, Sulu
PANLALAWIGAN PAGAMUTAN	----->NG LAGUNA (formerly San Pablo City District Hospital) San Pablo City, Laguna
PANOPDOPAN DISTRICT HOSPITAL	----->Lamut, Ifugao
PANOPIO MEDICAL AND	----->MATERNITY CLINIC 21 de Guzman St., Toril, Davao City
PANTALEON G. GOTLADERA	----->MEMORIAL HOSPITAL Pawa, Bulan, Sorsogon
PANTAO DISTRICT HOSPITAL	----->Pantao, Libon, Albay
PANTINOPLE MEDICAL CLINIC	----->Media, Argao, Cebu
PANTUKAN DISTRICT HOSPITAL	----->Pantukan, Compostela Valley
PARACELIS DISTRICT HOSPITAL	----->Paracelis, Mt. Province
PARAÑAQUE DOCTOR'S HOSPITAL	----->Better Living Subd., Parañaque City
PARANG DISTRICT HOSPITAL	----->Parang, Sulu
PASAY CITY GENERAL HOSPITAL	----->P. Burgos Street, Pasay City
PASCUAL GENERAL HOSPITAL	----->130 Baesa Street, Quezon City
PASIG CITY GENERAL HOSPITAL	----->Mi. Eusebio Ave., Maybunga, Pasig City
PASOLO MATERNITY AND	----->MEDICAL CLINIC, INC. 155 Pasolo St., Valenzuela City
PATHFINDER ESTATE HOSPITAL	----->Kabasalan, Zamboanga Sibugay
PAULINA LIM MEMORIAL HOSPITAL	----->Guindulman, Bohol
PAULINO HOSPITAL	----->Rizal Ave., Digos City, Davao del Sur
PAYAO MUNICIPAL HOSPITAL	----->Payao, Zamboanga del Sur
PAZZU MEDICAL CLINIC	----->(formerly Reroma Medical Clinic) Bansalan, Davao del Sur
PEDRO L. GINDAP MUNICIPAL	----->HOSPITAL Barbaza, Antique
PERPETUAL HELP CLINIC	----->Bunao, Ligao City, Albay
PERPETUAL HELP HOSPITAL	----->Malasiqui, Pangasinan
PERPETUAL HELP HOSPITAL	----->Olongapo City, Zambales
PERPETUAL HELP HOSPITAL	----->150 Laon-Laan St. Sampaloc, Manila
PERPETUAL SUCCOR HOSPITAL	----->AND MATERNITY INC. 836 F. Cayco St., Sampaloc, Manila
PERPETUAL SUCCOUR HOSPITAL	----->Gorordo Avenue, Cebu
PETER PAUL MEDICAL CENTER	----->OF CANDELARIA, INC. Regidor St., Candelaria, Quezon
PHILIPPINE CHILDREN'S	----->MEDICAL CENTER Quezon Avenue, Quezon City
PHILIPPINE GENERAL HOSPITAL	----->Taft Avenue, Ermita, Manila
PHILIPPINE HEART CENTER	----->East Avenue, Diliman Quezon City
PHILIPPINE ORTHOPEDIC CENTER	----->Ma. Clara cor. Banawe Street, Quezon City
PHILLIPS MEMORIAL HOSPITAL	----->Camp Phillip, Manolo Fortich, Bukidnon
PHILSAGA GENERAL HOSPITAL	----->Bunawan, Agusan Del Sur
PIDDIG DISTRICT HOSPITAL	----->Piddig, Ilocos Norte
PIEDAD MEDICAL CLINIC	----->San Mateo, Isabela
PILAR DISTRICT HOSPITAL	----->Pilar, Surigao del Norte
PILAR MEDICAL AND	----->MATERNITY CLINIC Angono, Rizal
PILILLA MEDICARE	----->COMMUNITYHOSPITAL Pililla, Rizal
PIMENTEL MEDICAL CLINIC	----->Bansalan, Davao del Sur
PINAMALAYAN COMMUNITY HOSPITAL	----->Papandayan, Pinamalayan Oriental Mindoro
PINAMALAYAN DOCTORS HOSPITAL	----->Pinamalayan, Oriental Mindoro
PIÑAN DISTRICT HOSPITAL	----->Piñan, Zamboanga del Norte
PINES CITY DOCTOR'S HOSPITAL	----->Magsaysay St., Baguio City
PINTUYAN DISTRICT HOSPITAL	----->Pintuyan, Southern Leyte
PINUKPUK DISTRICT HOSPITAL	----->Pinukpuk, Kalinga, Apayao
PIO DURAN MEMORIAL	----->DISTRICT HOSPITAL Pio Duran, Albay
PIRA HOSPITAL	----->Cabugao, Ilocos Sur
PLACER DISTRICT HOSPITAL	----->Placer, Surigao del Norte
PLARIDEL COUNTY HOSPITAL	----->Tabang, Plaridel, Bulacan
PLARIDEL EMERGENCY HOSPITAL	----->Plaridel, Bulacan
PNP GENERAL HOSPITAL	----->Camp Crame, Quezon City
PNP REGIONAL HEALTH SERVICES O2	----->Camp Adduru, Tuguegarao City Cagayan Valley
PNP STATION HOSPITAL	----->Cabahug, Cebu City
POLILLO MEDICARE HOSPITAL	----->Polillo, Quezon
POLOMOLOK MUNICIPAL HOSPITAL	----->Polomolok, South Cotabato
PORAC DISTRICT HOSPITAL	----->Babo Sacan, Porac, Pampanga
POTIA DISTRICT HOSPITAL	----->Sta. Maria, Alfonso Potia, Ifugao
POZORRUBIO COMMUNITY	----->HOSPITAL Pozorrubio, Pangasinan
PREMIERE GENERAL HOSPITAL	----->OF NUEVA ECIJA INC. Daang Sarile, Maharlika High Way, Cabanatuan City, Nueva Ecija
PREMIERE GENERAL	----->HOSPITAL OF NUEVA ECIJA Sukalayin, Baler, Aurora
PRES. CARLOS P. GARCIA	----->MUNICIPAL HOSPITAL Pitogo, Ubay, Bohol
PRES. DIOSDADO MACAPAGAL	----->HOSPITAL (formerly Gov. Mamerto Portillo District Hosp.) Tobias, Fornier, Antique
PRES. DIOSDADO MACAPAGAL	----->MEM. MED. CENTER Mabini St., Caloocan City
PRES. RAMON MAGSAYSAY	----->MEMORIAL HOSPITAL Iba, Zambales
PRES. ROXAS PROV'L. COMMUNITY HOSP.	----->(formerlyNorhtern Samar Prov'l. Hospital-Annex New Cebu Pres. Roxas, North Cotabato
PRIETO DIAZ MUNICIPAL HOSPITAL	----->Prieto Diaz, Sorsogon
PRIME GLOBAL CARE MEDICAL CTR.	----->INC. (formerly MALUTO FAMILY HEALTH SPECIALISTSLYING-IN & DIAGNOSTIC CLINIC Molino, Cavite
PRINCIPE COMMUNITY	----->MEDICAL HOSPITAL (formerly Baguio Community Medical Hospital) Baguio District, Davao City
PUDPUD POLYCLINIC AND	----->SPECIALTY CLINIC Sogod, South Leyte
PUERTO COMMUNITY HOSPITAL	----->Puerto, Cagayan de Oro City
PUYAOAN GENERAL HOSPITAL	----->Bulala,Camalaniugan, Cagayan
Q.C. ST. AGNES GEN. OSPITAL	----->241 Roosevelt Ave., Quezon City
QUEEN MARY HELP OF	----->CHRISTIAN HOSPITAL Cardona, Rizal
QUEEN MARY HOSPITAL	----->Ibaan, Batangas
QUEENSBERRY HOSPITAL	----->56 Ramirez St., Novaliches, Quezon City
QUEZON CITY GENERAL HOSPITAL	----->Seminary Road, Edsa Quezon City
QUEZON COMMUNITY INFIRMARY	----->Arellano Quezon, Isabela
QUEZON INSTITUTE	----->E. Rodriguez Sr., Ave. Quezon City
QUEZON MEDICARE HOSPITAL	----->Alfonso XIII, Quezon, Palawan
QUEZON MEDICAL HOSPITAL	----->Lucena City, Quezon
QUIJANO CLINIC AND HOSPITAL	----->National Highway, Tacurong City Sultan Kudarat
QUINAPONDAN COMMUNITY	----->HOSPITAL Quinapondan, Eastern, Samar
QUIRINO MEMORIAL MEDICAL	----->CENTER Katipunan Road Proj. 4, Q. C.
QUIRINO PROVINCIAL HOSPITAL	----->Cabarroguis, Quirino,Isabela
R DE C GALVEZ MEDICAL CENTER	----->San Ildefonso, Bulacan
R and L MEDICAL CLINIC	----->Aloran, Misamis Oriental
RTN FOUNDATION HOSPITAL, INC.	----->Rio Tuba, Bataraza, Palawan
R. S. CLINIC AND HOSPITAL	----->5038 Rizal St., Angeles City
RABARA CLINIC AND HOSPITAL	----->59 Rizal St., Vigan, Ilocos Sur
RAFAEL LAZATIN MEMORIAL	----->MEDICAL CENTER Visitacion St. cor. Pampang Road Villa Rosario, Pampang Angeles City
RAGAY DISTRICT HOSPITAL	----->Ragay, Camarines Sur
RALOTA-LAGRADA MEDICAL	----->CLINIC Sta. Cruz, Davao del Sur
RAMIRO COMMUNITY	----->HOSPITAL INC. Tagbilaran City
RAMON MASA SR. MEMORIAL	----->DISTRICT HOSPITAL Sibalom, Antique
RAMON TABIANA MEMORIAL	----->DISTRICT HOSPITAL Cabatuan, Iloilo
RAMONES GENERAL	----->HOSPITAL - ISABELA BRANCH San Mateo, Isabela
RAMOS GENERAL HOSPITAL	----->P. Hilario St., Tarlac, Tarlac
RANADA GENERAL HOSPITAL	----->Brgy. 9 Balintawak St. Laoag City
RAPU-RAPU DISTRICT HOSPITAL	----->Rapu-Rapu, Albay
RAYOS-VALENTIN HOSPITAL	----->Baltazar Subd., Paniqui, Tarlac
RECEL MEDICAL CLINIC	----->AND HOSPITAL Sta. Catalina, Ilocos Sur
REDOBLE MEDICAL CLINIC	----->Buug, Zamboanga Sibugay
REGION 1 MEDICAL CENTER	----->Arellano St. Dagupan City Pangasinan
REINHARD WIRTGEN	----->MEMORIAL HOSPITAL Poblacion, Alegria, Cebu
REMEDIOS TRINIDAD	----->ROMUALDEZ HOSPITAL Bgy. Calanipawan, Tacloban City
RENMAR SPECIALIST HOSPITAL	----->Santiago City, Isabela
REP. PEDRO TRONO MEMORIAL	----->DISTRICT HOSPITAL Guimbal, Iloilo
RESEARCH INSTITUTE FOR	----->TROPICAL MEDICINE Alabang, Muntinlupa City
RESONABLE HOSPITAL	----->Medarang, San Jose, Ilocos Sur
RETUERMA GENERAL HOSPITAL	----->Guinobatan, Albay
REVELO MEDICAL CLINIC	----->Clarin, Misamis Occidental
REYES CLINIC AND HOSPITAL	----->Sta. Maria, Ilocos Sur
RICARDO LIMSO MEDICAL	----->CENTER, INC. V. Illustre St., Davao City
RICARDO MANINGO MEMORIAL	----->HOSPITAL Camotes Island, Cebu
RICARDO P. RODRIGUEZ	----->MEMORIAL HOSPITAL Bulaon Resettlement San Fernando City, Pampanga
RICO MEDICAL  CLINIC	----->AND HOSPITAL Trento, Agusan Del Sur
RICO'S HOSPITAL	----->Tabaco City, Albay
RIDON'S ST. JUDE MEDICAL CENTER	----->Olongapo City, Zambales
RILLERA MEDICAL HOSPITAL	----->Arosa, Germinal Bolinao, Pangasinan
RINCONADA MEDICAL CENTER	----->Nabua, Camarines Sur
RIVERA MEDICAL CENTER, INC.	----->7302 National Highway San Francisco, Panabo City
RIZAL MEDICAL CENTER	----->Pasig Blvd., Pasig City
RIZAL PROVINCIAL HOSPITAL	----->Tomas Claudio, Morong, Rizal
ROA MEDICAL CLINIC	----->Cogon, Balingasag Misamis Oriental
RODOLFO MORALES MEDICAL CLINIC	----->(former Morales Medical Clinic) Sta. Maria, Davao Del Sur
ROEL I. SENADOR, MD	----->MEMORIAL HOSPITAL Tupi, South Cotabato
ROGACIANO H. MERCADO	----->MEMORIAL HOSPITAL Pob., Sta. Maria, Bulacan
ROLDAN MEDICAL CLINIC	----->M'lang, North Cotabato
ROMANA PANGAN DISTRICT	----->HOSPITAL Floridablanca, Pampanga
ROMEL CRUZ HOSPITAL	----->Baog, Matimbo, Malolos, Bulacan
ROMEO B. SIBUD COUNTY	----->HOSPITAL Pob. Titay, Zamboanga Sibugay
ROMBLON DISTRICT	----->HOSPITAL Romblon, Romblon
ROMBLON PROVINCIAL	----->HOSPITAL Odiongan, Romblon
ROMUALDEZ-KATIKU	----->COMMUNITY HOSPITAL Romualdez, Pres. Quirino Sultan Kudarat
ROQUERO HOSPITAL	----->Sapang Palay San Jose del Monte City, Bulacan
ROSARIO MEMORIAL HOSPITAL	----->San Roque, Guagua, Pampanga
ROSARIO-TRINIO MEDICAL	----->CLINIC Labrador, Pangasinan
ROSARY OF VIRGIN MARY	----->HOSPITAL Sta. Elena, Camarines Norte
ROXAS DISTRICT HOSPITAL	----->Odiong, Roxas, Oriental Mindoro
ROXAS MEDICARE HOSPITAL	----->Roxas, Palawan
ROXAS MEMORIAL PROVINCIAL	----->HOSPITAL Arnaldo Blvd. Roxas City, Capiz
RUGAY MATERNITY AND	----->GENERAL HOSPITAL Sabang Baliuag, Bulacan
SDS MEDICAL CENTER	----->Concepcion Dos, Marikina City
SMD GENERAL HOSPITAL	----->Menor St. Ext., Pangarungan Village, Marawi City, Lanao del Sur
S.M. LAO MEMORIAL CITY	----->GENERAL HOSPITAL Manabay, Misamis Occidental
SS LUMAPAS HOSPITAL	----->Molave, Zamboanga del Sur
SSMC- SATELITE HOSPITAL	----->Abutan Bldg., Gen. Trias, Cavite
SSMC - SATELLITE HOSPITAL -	----->ROSARIO BRANCH Rosario, Cavite City
SABAL HOSPITAL INC.	----->Cagayan de Oro City, Misamis Oriental
SABALLA-ROSARIO HOSPITAL	----->Binalonan, Pangasinan
SABATER HOSPITAL	----->Caruncho Ave. San Nicolas Pasig City
SABTANG COMMUNITY HOSPITAL	----->Sabtang, Batanes
SANCTISSIMO ROSARIO GEN. HOSPITAL	----->2 Espiritu St., Marulas Valenzuela City
SACRED HEART HOSPITAL	----->OF MALOLOS, INC. Maguinhawa, Malolos, Bulacan
SACRED HEART HOSPITAL	----->Villaznar, Rd., Urgello, Cebu
SACRED HEART MEDICAL CENTER	----->Sto. Domingo, Angeles City Pampanga
SACRED HEART MEDICAL	----->SPECIALIST HOSPITAL Midsayap, North Cotabato
SAGRADA FAMILIA HOSPITAL	----->Tangos, Baliuag, Bulacan
SAGRADO MEDICAL &	----->CHILDREN'S CLINIC Brooke's Point, Palawan
SALAZAR POLYCLINIC	----->Atienza, Lemery, Batangas
SALCEDO MEDICARE &	----->COMMUNITY HOSPITAL Salcedo, Ilocos Sur
SALOMON MANGILET	----->MATERNITY & MEDICAL CLINIC Kapalong, Davao del Norte
SALUG VALLEY MEDICAL CENTER	----->(formerly IGANO COMMUNITY HOSPITAL) Molave, Zamboanga Del Sur
SALVACION CLINIC	----->Sipocot, Camarines Sur
SALVACION OPPUS YNIGUEZ MEMORIAL	----->HOSPITAL (formerlySOUTHERN LEYTE PROVINCIAL HOSPITAL Maasin, Southern Leyte
SALVADOR GENERAL HOSPITAL	----->Palimbo, Concepcion, Tarlac
SALVE REGINA GENERAL	----->HOSPITAL, INC. Dela Paz, Pasig City
SAMAL DISTRICT HOSPITAL	----->Peñaplata , Igacos, Davao del Norte
SAMAR PROVINCIAL HOSPITAL	----->Catbalogan, Samar
SAMPALOC MEDICARE	----->COMMUNITY HOSPITAL Sampaloc, Quezon
SAN ANDRES MUNICIPAL	----->HOSPITAL San Andres, Romblon
SAN ANTONIO DISTRICT	----->HOSPITAL San Mariano, San Antonio Nueva Ecija
SAN ANTONIO DISTRICT	----->HOSPITAL San Antonio, Northern Samar
SAN ANTONIO MEDICAL	----->CENTER OF LIPA, INC. C.M. Recto Ave.,Lipa City
SAN CARLOS CITY HOSPITAL	----->San Carlos City Negros Occidental
SAN CARLOS DOCTORS	----->HOSPITAL Nat'l H-way, San Carlos City, Negros Occidental
SAN DIEGO DE ALCALA	----->GENERAL HOSPITAL AguinaldoSt., cor. D.Tanada Gumaca, Quezon
SAN DIEGO GENERAL HOSPITAL	----->Banga, Plaridel, Bulacan
SANDIG MEDICAL CLINIC	----->& HOSPITAL Ledesma St., Tacurong Sultan Kudarat, Tacurong City
SAN FERNANDINO HOSPITAL	----->Bo. Dolores, San Fernando City Pampanga
SAN FRANCISCO MUNICIPAL	----->HOSPITAL Brgy. Cawayan I, San Francisco Quezon
SAN GERONIMO GENERAL HOSPPITAL	----->Morong, Rizal
SAN ISIDRO HOSPITAL	----->Angono, Rizal
SAN JOSE CITY GENERAL HOSPITAL	----->San Jose City, Nueva Ecija
SAN JOSE DISTRICT HOSPITAL	----->San Jose, Batangas
SAN JOSE DISTRICT HOSPITAL	----->San Jose, Occ. Mindoro
SAN JOSE DISTRICT HOSPITAL	----->San Jose, Romblon
SAN JOSE HOSPITAL AND	----->TRAUMA CENTER Gen. Mariano alvarez, Cavite City
SAN JOSE HOSPITAL AND	----->TRAUMA CENTER Mayapa, Calamba City, Laguna
SAN JOSE MEDICARE	----->COMMUNITY HOSPITAL San Jose, Camarines Sur
SAN JUAN BAUTISTA HOSPITAL	----->Nandacan, Bautista, Pangasinan
SAN JUAN DE DIOS	----->EDUCATIONAL FOUNDATION 2772 Roxas Blvd., Pasay City
SAN JUAN DISTRICT HOSPITAL	----->Talihiban San Juan, Batangas
SAN JUAN DOCTOR'S HOSPITAL, INC.	----->Brgy. Calit Calit, San Juan, Batangas
SAN JUAN MEDICAL CENTER	----->N. Domingo St., Sta. Cruz, Manila
SAN LAZARO HOSPITAL	----->Quiricada St., Sta. Cruz, Manila
SAN LORENZO HOSPITAL HEALTH	----->MANAGEMENT CO., INC. Quirino Highway Brgy., Pasong Putik, Novaliches, Quezon City
SAN LORENZO HOSPITAL HEALTH	----->MANAGEMENT CO., INC. Susano Rd., Deparo Street Caloocan City
SAN LORENZO RUIZ	----->WOMEN'S HOSPITAL Santulan, Malabon
SAN LUIS DISTRICT HOSPITAL	----->San Luis, Pampanga
SAN MARCELINO DISTRICT	----->HOSPITAL San Marcelino, Zambales
SAN MARIANO MEDICARE	----->COMMUNITY HOSPITAL San Mariano, Isabela
SAN MIGUEL COMMUNITY	----->HOSPITAL San Miguel, Surigao del Sur
SAN MIGUEL DISTRICT HOSPITAL	----->Sta. Rita Old, San Miguel Bulacan
SAN MIGUEL MUNICIPAL	----->INFIRMARY HOSPITAL San Miguel, Bohol
SAN NARCISO MUNICIPAL	----->HOSPITAL Brgy Bayanihan, San Narciso, Quezon
SAN PABLO CITY GENERAL	----->HOSPITAL San Jose, San Pablo City
SAN PABLO COLLEGES	----->MEDICAL CENTER San Rafael, San Pablo City Laguna
SAN PABLO DOCTORS HOSPITAL	----->55 A. Mabini, San Pablo City Laguna
SAN PASCUAL BAYLON MATERNITY	----->AND GENERAL HOSPITAL Prov'l Rd., Brgy.Sto.Niño Paombong, Bulucan
SAN PEDRO HOSPITAL OF	----->DAVAO CITY, INC. Sta. Ana, Davao City
SAN PEDRO MUNICIPAL HOSPITAL	----->Puesto Azul Ph. 1 San Pedro, Laguna
SAN RAMON HOSPITAL	----->38 Gen. Ordoñez Street Marikina City
SAN ROQUE HOSPITAL	----->Liang, Malolos, Bulacan
SAN ROQUE MEDICAL CLINIC	----->249 T. Montillano St. Alabang, Muntinlupa City
SAN SEBASTIAN DISTRICT HOSPITAL	----->Sablayan, Occ. Mindoro
SAN VICENTE DISTRICT HOSPITAL	----->San Vicente, Northern Samar
SANTIAGO'S PEDIATRIC HOSPITAL	----->J. P. Rizal St., Sta. Maria, Bulacan
SANTISSIMA TRINIDAD HOSPITAL	----->Pinagbakahan, Malolos City, Bulacan
SANTISSIMA TRINIDAD	----->HOSPITAL OF DAET Camambuangan, Daet Camarines Norte
SANCTISSIMO ROSARIO	----->GENERAL HOSPITAL Marulas, Valenzuela City
SANTOS GENERAL HOSPITAL	----->OF MALOLOS, INC. F. Estrella St., Sto. Rosario Malolos, Bulacan
SARANGANI MUNICIPAL	----->HOSPITAL Sarangani, Sarangani
SAROMA HOSPITAL	----->Malalag, Davo del Sur
SCHISTOSOMIASIS HOSPITAL	----->Palo, Leyte
SEAMEN'S HOSPITAL	----->Cabildo Street, Intramuros Manila
SEBASTE COMMUNITY HOSPITAL	----->Sebaste, Antique
SEMIRARA COAL CORP. HOSP.	----->Semirara Island, Caluya Antique
SEN. GERARDO M. ROXAS	----->MEMORIAL HOSPITAL Dao, Capiz
SEN. NINOY AQUINO	----->MUNICIPAL HOSPITAL Poblacion Sen. Ninoy Aquino Sultan Kudarat
SEÑOR STO. NIÑO HOSPITAL	----->Burgos St., Camiling, Tarlac
SEÑOR STO. NIÑO HOSPITAL, INC.	----->Pob. Sur, Mayambang, Pangasinan
SEÑOR TESORO HOSPITAL	----->Pob. ll Victoria, Oriental Mindoro
SEVERO VERALLO MEMORIAL	----->HOSPITAL Bogo, Cebu
SIARGAO DISTRICT HOSPITAL	----->Dapa, Surigao del Norte
SIASI DISTRICT HOSPITAL	----->Siasi, Sulu
SIBUTAD MUNICIPAL HOSPITAL	----->Sibutad, Zamboanga del Norte
SIBUYAN DISTRICT HOSPITAL	----->Cajidiocan, Romblon
SILANG GENERAL HOSPITAL	----->M. H. Del Pilar St., Silang, Cavite
SILLIMAN MEDICAL CENTER	----->Aldecoa Road, Laguna Dumaguete City, Negros Oriental
SILVA'S CLINIC	----->Tanauan City, Batangas
SIMBULAN STO. NIÑO HOSPITAL	----->Don Carlos, Bukidnon
SINAIT DISTRICT HOSPITAL	----->Sinait, Ilocos Sur
SINAWILAN CLINIC & HOSPITAL	----->Matanao, Davao del Sur
SINDANGAN DISTRICT HOSP.	----->Sindangan, Zamboanga del Norte
SING MEDICAL SERVICES DIAGNOSTIC	----->CENTER & HOSPITAL (formerly SING CLINIC AND HOSPITAL Baltazar Subd., Paniqui, Tarlac
SIPOCOT DISTRICT HOSPITAL	----->Sipocot, Camarines Sur
SIRUMA MUNICIPAL HOSPTAL	----->Siruma, Camarines Sur
SIQUIJOR PROVINCIAL	----->HOSPITAL Siquijor, Siquijor
SOCORRO DISTRICT HOSPITAL	----->Socorro, Surigao del Norte
SOGOD DISTRICT HOSPITAL	----->Sogod, Southern Leyte
SOHAYA MEDICAL AND	----->DIAGNOSTIC HOSPITAL Marawi City
SOLER GENERAL HOSPITAL	----->Mabini St., Bgy. 6, Sariaya, Quezon
SOLLER GENERAL HOSPITALP	----->Vira, Roxas, Isabela
SOLOMON'S HOSPITAL	----->San Juan, Batangas
SOMOSO GENERAL HOSPITAL	----->Panabo, Davao del Norte
SORIANO LEYBLE MEDICAL	----->AND MATERNITY HOSPITAL 144 San Jose St., San Isidro Antipolo City
SORILLA MEDICAL AND	----->MATERNITY CLINIC AND HOSPITAL National Highway, Tulunan North Cotabato
SORSOGON MEDICAL	----->MISSION GROUP HOSP. & HEALTH SERVICE COOP. Sorsogon City
SOUTH COTABATO	----->PROVINCIAL HOSPITAL Koronadal, South Cotabato
SOUTH DAVAO MEDICAL	----->SPECIALIST Padala, Davao del Sur
SOUTH M'LANG MEDICAL CLINIC	----->AND HOSPITAL (former Notre Dame Clinic) M'lang, North Cotabato
SOUTH SUPERHIGHWAY	----->MEDICAL CENTER Km. 17 West Service Rd. South Superhighway Parañaque City
SOUTH UPI MUNICIPAL HOSP.	----->South UPI, Maguindanao
SOUTHERN ISABELA	----->GENERAL HOSPITAL Santiago City, Isabela
SOUTHERN LUZON HOSPITAL	----->AND MEDICAL CENTER Greenfield Ave., Don Jose, Sta. Rosa City Laguna
SOUTHERN NEGROS	----->DOCTORS HOSPITAL Mabinay Highway Kabankalan City, Negros Occ.
SOUTHERN PALAWAN	----->PROVINCIAL HOSPITAL Brookes Point, Palawan
SOUTHERN PHILIPPINES MEDICAL	----->CENTER (fornerly Davao Medical Center) Bajada, Davao City
SPECIALIST GROUP HOSP.	----->AND TRAUMA CENTER Tapuac District, Dagupan City
ST. ANDREW HOSPITAL	----->Talisay, Batangas
ST. ANN MEDICAL HOSPITAL	----->Poblacion, Quezon, Bukidnon
ST. ANNE CLINIC	----->Cabadbaran, Agusan del Norte
ST. ANNE GENERAL HOSPITAL, INC.	----->51 Gomez St., Red V Lucena City, Quezon
ST. ANTHONY COLLEGE	----->HOSPITAL San Roque Ext., Roxas City
ST. ANTHONY MOTHER	----->AND CHILD HOSPITAL San Nicolas, Basak, Cebu City
ST. ANTHONY OF MARIKINA	----->MEDICAL CENTER San Roque, Marikina City
ST. CAMILLUS HOSPITAL	----->Calbayog City, Samar
ST. CAMILLUS HOSPITAL	----->OF MATI FOUNDATION, INC. Madang, Mati, Davao Oriental
ST. CATHERINE HOSPITAL	----->Central East I, Bagar, La Union
ST. CATHERINE OF ALEXANDRIA	----->FOUNDATION AND MEDICAL CENTER (formerly St. Catherine of Alexandria Maternity and Child Care Clinic) 4163 Rizal Ext., Angeles City
ST. CECILIA HOSPITAL	----->Tiaong, Quezon
ST. CHRISTIANA MATERNITY	----->LYING-IN CLINIC Manggahan, Pasig City
ST. CLAIRE HOSPITAL	----->Quezon, Bukidnon
ST. CLAIRE'S MEDICAL CENTER	----->1838 Dian Street, Palanan Makati City
ST. CLEMENT MEDICAL CLINIC	----->Alaminos, Laguna
ST. DOMINIC MEDICAL	----->CENTER, INC. Talaba, Bacoor, Cavite
ST. FELIX MEDICAL HOSPITAL	----->Bago Aplaya, Talorio, Davao City
ST. FRANCES CABRINI	----->MEDICAL CENTER Sto. Tomas, Batangas
ST. FRANCIS OF ASSISI MATERNITY	----->AND GENERAL HOSPITAL 289 St. Francis, Meycauayan, Bulacan
ST. GABRIEL HOSPITAL	----->Kalibo, Aklan
ST. JAMES HOSPITAL	----->Pantay Dayan, Vigan City
ST. JAMES HOSPITAL AND	----->MEDICAL CLINIC Compostela, Compostela Valley
ST. JAMES HOSPITAL, INC.	----->Sta. Rosa, Laguna
ST. JAMES THE GREATER	----->HOSPITAL Santiago St. Pob. Ibaan Batangas
ST. JOHN GENERAL	----->HOSPITAL I Buug, Zamboanga Sibugay
ST. JOHN HOSPITAL	----->Rasay St., Toril, Davao City
ST. JOHN HOSPITAL	----->Gao, Camarines Sur
ST. JOHN HOSPITAL, INC.	----->Panganiban St., Naga City
ST. JOHN MEDICAL AND	----->MATERNITY CLINIC Cabiao, Nueva Ecija
ST. JOHN THE APOSTLE	----->HOSPITAL Labo, Camarines Norte
ST. JOHN THE BAPTIST	----->MEDICAL CENTER INC. Parian, Calamba City, Laguna
ST. JOSEPH MEDICAL CLINIC	----->Dimasalang, Masbate
ST. JOSEPH MEDICAL CLINIC	----->Magallanes, Agusan del Norte
ST. JOSEPH SOUTHERN	----->BUKIDNON HOSPITAL Sayre Highway, Mararag Bukidnon
ST. JUDE CLINIC AND HOSPITAL	----->Baao, Camarines Sur
ST. JUDE CLINIC AND HOSPITAL	----->Sto. Niño, South Cotabato
ST. JUDE FAMILY HOSPITAL	----->Batong Malaki, Los Baños, Laguna
ST. JUDE HOSPITAL AND	----->MEDICAL CENTER Dimasalang, Sampaloc, Manila
ST. JUDE HOSPITAL OF LABO	----->Labo, Camarines Norte
ST. JUDE MEDICAL CLINIC	----->Bulan, Sorsogon
ST. JUDE'S HOSPITAL, INC.	----->Kalibo, Aklan
ST. JUDE THADDEUS WOMEN	----->AND CHILDREN'S HOSPITAL Brgy. 6, Malaybalay City, Bukidnon
ST. LAWRENCE HOSPITAL	----->Poblacion III, Victoria Oriental Mindoro
ST. LOUIS MEDICAL CLINIC	----->AND HOSPITAL 23 Judge Quirino Mercado Ave., Tacurong City, Sultan Kudarat
ST. LOUIS UNIVERSITY HOSP.	----->OF THE SACRED HEART Assumption Rd., Baguio City
ST. LUKE'S MEDICAL CENTER	----->279 E. Rodriguez Sr. Blvd., Quezon City
ST. LUKE'S MEDICAL CENTER	----->- GLOBAL CITY Bonifacio Global City, Taguig
ST. MAGDALENE HOSPITAL	----->San Jose, Occidental Mindoro
ST. MARTIN DE PORRES	----->CHARITY HOSPITAL 70 A. Bonifacio St., San Juan
ST. MARTIN DE PORRES	----->HOSPITAL Candon, Ilocos Sur
ST. MARTIN DE PORRES	----->MEDICAL CLINIC Masbate City
ST. MARTIN MATERNITY &	----->PEDIATRICS HOSPITAL Noveleta, Cavite
ST. MARTIN'S MISSION HOSPITAL	----->San Roque, Pob., Sablayan, Occidental Mindoro
ST. MARY OF LOURDES	----->GENERAL HOSPITAL (former St. Mary General Hospital) Toril,Davao City
ST. MARY'S MATERNITY AND	----->CHILDREN'S HOSPITAL, INC. Quezon Ave. Ext., Villaverde Iligan City, Lanao del Norte
ST. MARY'S MEDICAL SERVICES,	----->INC. (formerly St. Mary's Hospital) J. P. Rizal St., Poblacion Sta. Maria, Bulacan
ST. MATTHEWS MEDICAL HOSPITAL	----->60 Gen. Luna, Banaba San Mateo, Rizal
ST. MAZENOD HOSPITAL	----->Silang, Cavite
ST. MICHAEL FAMILY HOSPITAL	----->Marilao, Bulacan
ST. MICHAEL GENERAL HOSPITAL	----->Bacacay, Albay
ST. MICHAEL MEDICAL CENTER	----->220 Bacoor, Cavite
ST. NAZARIUS MEDICAL CLINIC	----->Malvar, Batangas
ST. NICHOLAS DOCTORS	----->HOSPITAL Abelo, San Nicolas, Batangas
ST. PATRICK'S HOSPITAL AND	----->MEDICAL CENTER, INC. Lopez Jaena St., Batangas City
ST. PAUL GENERAL HOSPITAL	----->Quezon St., Pinamalayan Oriental Mindoro
ST. PAUL'S HOSPITAL	----->Gen. Luna Street, Iloilo City
ST. PAUL'S HOSPITAL	----->BULACAN, INC. Biñang II, Bocaue, Bulacan
ST. PAUL HOSPITAL CAVITE, INC.	----->Dasmariñas, Cavite
ST. PAUL HOSPITAL OF	----->TUGUEGARAO Ugac Hi-way, Tuguegarao City
ST. PETER CLAVER HOSPITAL	----->(former St. Luke's Emergency Hospital) Dagupan, Tabuk, Kalinga
ST. PETER GENERAL HOSPITAL	----->Quezon St., Calauag, Quezon
ST. RAFHAEL HOSPITAL	----->Baao, Camarines Sur
ST. RAPHAEL FOUNDATION	----->AND MEDICAL CENTER Dau, Mabalacat, Pampanga
ST. THEODORE'S HOSPITAL	----->Segada, Mt. Province
ST. THERESA WELLNESS	----->CENTER Talogtog, Dolores, Abra
ST. THERESE HOSPITAL	----->Layawan BonifacioOroquieta City, Misamis Occidental
ST. THERESE-MTC COLLEGES	----->HOSPITAL Jalandoni, San Agustin, Iloilo City
ST. THERESE OF THE	----->CHILD JESUS HOSPITAL INC. Jimenez St., Bacon District, Sorsogon
ST. THOMAS AQUINAS HOSPITAL	----->Sta. Fe Subdivision, Binalonan Pangasinan
ST. VICTORIA HOSPITAL	----->444 J. P. Rizal St., Lamuan Marikina City
ST. VINCENT DE FERRER HOSP.	----->Gao, Camarines Sur
ST. VINCENT DE PAUL COLLEGE	----->& MATERNITY AND HOSPITAL Mangagoy, Bislig City, Surigao del Sur
ST. VINCENT DE PAUL HOSPITAL	----->Sto. Tomas, Batangas
ST. VINCENT EENT HOSPITAL	----->Poblacion, Bustos, Bulacan
ST. VINCENT GENERAL HOSPITAL - CEBU CITY	----->210-D Osmeña Blbd., Ext., Cebu City
ST. VINCENT HOSPITAL	----->149 South 2nd St., Tangub City Misamis Occidental
ST. VINCENT HOSPITAL	----->Masbate City
ST. VINCENT MEDICAL CLINIC	----->Lungsoda-an, Hinundayan South Leyte
STA. ANA COMMUNITY HOSPITAL	----->Centro, Sta. Ana, Cagayan Valley
STA. ANA HOSPITAL	----->New Panaderos St., Sta. Ana, Manila
STA. CECILIA MEDICAL CENTER	----->Iba, Zambales
STA. CLARA DE MONTEFALCO	----->MEDICAL CENTER, INC. Km. 20 Service Rd., North Expressway Malhacan Meycauayan, Bulacan
STA. CRUZ COMMUNITY HOSPITAL	----->Sta. Cruz, Occidental, Mindoro
STA. CRUZ DISTRICT HOSPITAL	----->Brgy. Lapu-Lapu Sta. Cruz, Marinduque
STA. CRUZ HOSPITAL	----->Calumpit, Bulacan
STA. CRUZ LAGUNA POLYMEDIC INC.	----->780 Nat'l. Hi-way, Patimbao Sta. Cruz, Laguna
STA. ISABEL GENERAL	----->HOSPITAL, INC. Sta. Filomena, Dipolog City
STA. LUCIA DISTRICT HOSPITAL	----->Sta. Lucia, Ilocos Sur
STA. MARCELA DISTRICT HOSPITAL	----->Sta. Marcela, Kalinga
STA. MARIA MEDICAL CLINIC	----->AND HOSPITAL Sta. Maria, Davao del Sur
STA. MARIA VILLAGE CLINIC	----->Calapan City, Oriental Mindoro
STA. MARIA JOSEFA	----->FOUNDATION HOSPITAL Francia, Iriga City, Camarines Sur
STA. MONICA HOSPITAL	----->138 A. Bonifacio Ave. Tañong, Marikina City
STA. MONICA MUNICIPAL	----->HOSPITAL Sta. Monica, Surigao del Norte
STA. RITA DE BACLARAN HOSPITAL	----->95 G. Cruz Street, Baclaran Parañaque City
STA. ROSA COMMUNITY	----->HOSPITAL Olango Island, Lapu-Lapu City
STA. ROSA COMMUNITY	----->HOSPITAL Sta. Rosa, Laguna
STA. ROSA HOSPITAL &	----->MEDICAL CENTER RSBS Blvd. San Lorenzo Subd. Balibago, Sta. Rosa City, Laguna
STA. TERESITA HOSPITAL, INC.	----->Marcos, Ilocos Norte
STA. TERESITA GENERAL	----->HOSPITAL 100 D. Tuazon St., Quezon City
STO. DOMINGO DISTRICT	----->HOSPITAL Pulong Bule, St. Domingo Nueva Ecija
STO. NIÑO DE CASIPIT HOSPITAL	----->Lingayen, Pangasinan
STO. NIÑO HOSPITAL	----->Poblacion, Bustos, Bulacan
STO. NIÑO HOSPITAL	----->Brgy. Baliw Laud, Sta. Maria Ilocos Sur
STO. NIÑO HOSPITAL	----->Mercedes Rd., Daet, Camarines Norte
STO. NIÑO OF PHILEX	----->MINES HOSPITAL Padcal, Tuba, Benguet
STO. NIÑO MEDICAL CLINIC	----->Cuenca, Batangas
STO. ROSARIO HOSPITAL	----->Rosario, Batangas
STO. ROSARIO MATERNITY	----->AND MEDICAL CLINIC Rizal St., Dinalupihan, Bataan
STO. TOMAS GENERAL HOSPITAL	----->Pres. Laurel Highway San Roque, Batangas
STO. TOMAS UNIVERSITY	----->HOSPITAL España, Sampaloc, Manila
STO. TOMAS MUNICIPAL HOSPITAL	----->Malvar Ave., Pob. II, Sto. Tomas Batangas
STS. FRANCIS AND PAUL	----->GENERAL HOSPITAL Farconville Subd.,San Pablo City
STS. PETER AND PAUL HOSPITAL	----->612 Alegre St., Balogo, Sorsogon
SUERO GENERAL HOSPITAL	----->Cabugao, Ilocos Sur
SULOP MEDICAL CLINIC	----->Sulop, Davao del Sur
SULTAN KUDARAT DOCTORS	----->HOSPITAL, INC. Tacurong Poblacion Sultan Kudarat
SULTAN KUDARAT MEDICAL	----->SPECIALIST CENTER, INC. Alunan H- Way, Tacurong Sultan Kudarat
SULTAN KUDARAT	----->PROVINCIAL HOSPITAL Isulan, Sultan Kudarat
SULTAN NAGA DIMAPORO PROV''L	----->HOSPITAL (formerly Sultan Naga Dimaporo District Hospital) Sultan Naga, Dimaporo Lanao del Sur
SULU MEDICAL SPECIALISTS HOSPITAL	----->Martinez St., Jolo, Sulu
SULU PROVINCIAL HOSPITAL	----->San Raymundo, Jolo Sulu
SULU SANITARIUM HOSPITAL	----->San Raymundo, Jolo Sulu
SUNGA HOSPITAL	----->Digos City, Davao del Sur
SURIGAO MEDICAL CENTER, INC	----->Surigao City, Surigao del Norte
SURRALAH COMMUNITY	----->HOSPITAL Surralah, South Cotabato
SUSANO UY MEMORIAL HOSPITAL INC.	----->Lopez Jaena, MIsamis Occidental
SWU-ARGAO COMMUNITY HOSPITAL	----->Lamacan, Argao, Cebu City
TAAL POLYMEDIC HOSPITAL AND	----->MEDICAL CENTER (formerly Taal Polymedic Hospital) Taal, Batangas
TABACO COLLEGE HOSPITAL	----->Tabaco, Albay
TABANGO COMMUNITY	----->HOSPITAL Tabango, Northern Leyte
TABLAS ISLAND DISTRICT	----->HOSPITAL San Agustin, Romblon
TABLAS DOCTOR'S HOSPITAL	----->N. Aquino St., Liwayway Odiongan Romblon
TABUK FAMILY CLINIC	----->Poblacion, Tabuk, Kalinga
TACLOBAN CITY HOSPITAL	----->Tacloban City
TAFT DISTRICT HOSPITAL	----->Taft, Eastern Samar
TAGALOAN POLYMEDIC	----->GENERAL HOSPITAL Tagaloan, Misamis Oriental
TAGAYTAY HOSPITAL AND	----->MEDICAL CENTER Tagaytay Rotonda, Tagaytay City
TAGBILARAN COMMUNITY	----->HOSPITAL CORP. Tagbilaran City
TAGBILARAN MATERNITY AND	----->CHILDREN'S HOSPITAL, INC. (formerly Tagbilaran Puericulture Center and Maternity House, Inc.) 169-J, A. Clarin St., Tagbilaran City
TAGUIG DOCTORS' HOSPITAL	----->M. L. Quezon St. Bagumbayan, Taguig
TAGUDIN GENERAL HOSPITAL	----->& CAPILLARIAS CENTER Bio Tagudin, Ilocos Sur
TAGUIG-PATEROS DISTRICT HOSPITAL	----->East Service Rd., Western Bicutan, Taguig
TAGUM DOCTORS HOSPITAL	----->Highway 54, Tagum City
TALAVERA EXTENSION HOSPITAL	----->Talavera, Nueva Ecija
TALISAY DISTRICT HOSPITAL	----->San Isidro, Talisay, Cebu
TALON GENERAL HOSPITAL	----->F. Tañedo St.,Tarlac City
TAMOLA-TAN MEDICAL HOSPITAL	----->Canubay, Oroquieta City Misamis Occidental
TAMONDONG MEMORIAL	----->CLINIC AND HOSPITAL Ala, Esperanza, Sultan Kudarat
TAMONDONG-DELOS	----->CIENTOS MEDICAL CLINIC Padada, Davao del Sur
TAMPARAN DISTRICT HOSPITAL	----->Tamparan, Lanao del Sur
TAMPARAN MEDICAL FOUNDATION, INC.	----->Picarabawan, Tampalan, Lanao Del Sur
TANAY COMMUNITY HOSPITAL	----->Tanay, Rizal
TANAY GENERAL HOSPITAL	----->Tanay, Rizal
TANCHULING HOSPITAL	----->Imperial, Subd., Legaspi City
TANHO MEDICAL CLINIC	----->Plaridel, Misamis Occidental
TANZA FAMILY GENERAL	----->HOSPITAL Daang Maya, Tanza, Cavite
TAPAZ DISTRICT HOSPITAL	----->Tapaz, Capiz
TARANGNAN COMMUNITY	----->HOSPITAL Tarangnan, Western Samar
TARLAC PROVINCIAL HOSPITAL	----->San Vicente, Tarlac, Tarlac
TARONGOY MEDICAL CLINIC	----->Quezon Ave., Midsayap North Cotabato
TAYABAS COMMUNITY	----->HOSPITAL, INC. Tayabas, Quezon
TAYTAY DISTRICT HOSPITAL	----->Taytay, Palawan
TAYTAY EMERGENCY	----->HOSPITAL San Isidro, Taytay, Rizal
TAYUG FAMILY HOSPITAL	----->Tayug, Pangasinan
TEODORO B. GALAGAR	----->MEMORIAL HOSPITAL Jagna, Bohol
TERESITA L. JALANDONI	----->PROVICIAL HOSPITAL Brgy. Lantad, Silay City Negos Occidental
THE BLACK NAZARENE	----->SPECIALTY HOSPITAL 29 Bonoan St., Brgy. San Nicolas Ilocos Norte
THE DOCTOR'S HOSPITAL, INC.	----->B.S. Aquino Drive, Bacolod City
THE FAMILY CLINIC	----->1474 Ma. Clara St. Sampaloc, Manila
THE LORD'S HOSPITAL	----->Meymart Rd., Calvario Meycauayan, Bulacan
THE MEDICAL CITY	----->Ortigas Avenue, Pasig City
THE MOTHER REGINA MEDICAL FACILITIES	----->(formerly Mother Regina Hospital) No. Ruby St., Doña Juan Subd., Rosario, Pasig City
THE ROSS MAURICIO	----->MEMORIAL HOSPITAL 109 Quezon St., Dist. II Cauayan City, Isabela
TICAO DISTRICT HOSPITAL	----->San Jacinto, Masbate
TIGLAO MEDICAL CENTER	----->FOUNDATION, INC. San Joaquin, Mabalacat Pampanga
TINAMBAC MEDICARE	----->COMMUNITY HOSPITAL Tinambac, Camarines Sur
TINAMBAC MUNICIPAL INFIRMARY	----->Binmaley, Tinambac Camarines Sur
TINOC DISTRICT HOSPITAL	----->Tinoc, Ifugao
TOJONG INC. MATERNITY	----->CLINIC AND GENERAL HOSPITAL Lapu-Lapu City
TOLEDO CITY GENERAL HOSPITAL	----->Toledo City
TOLENTINO CLINIC & HOSPITAL	----->Sto. Domingo, Ilocos Sur
TOMAS LACHICA DISTRICT	----->HOSPITAL Jose Abad Santos, Davao del Sur
TOMAS-CACAL MEDICAL	----->CLINIC & HOSPITAL Magsaysay, Alicia, Isabela
TOMBOC-SALAYOG HOSPITAL	----->San Emmanuel, Tacurong City
TONDO MEDICAL CENTER	----->Honorio Lopez Blvd. Balut, Tondo
TORRIJOS MUNICIPAL	----->HOSPITAL Torrijos, Marinduque
TRINITY WOMAN AND CHILDREN	----->CENTER "THE BIRTHPLACE" 2732 New Panaderos St., Sta. Ana, Manila
TRIUMPH OF THE CROSS HOSPITAL	----->Manabo, Abra
TUAN LIGADDUNG LIPAE	----->DISTRICT HOSPITAL Sapa-Sapa, Tawi-Tawi
TUAO DISTRICT HOSPITAL	----->Tuao, Cagayan Valley
TUBIGON COMMUNITY	----->HOSPITAL Potohan, Tubigon, Bohol
TUBOD COMMUNITY HOSPITAL	----->San Butonio, Tubod Lanao Del Norte
TUBURAN DISTRICT HOSPITAL	----->Tuburan, Cebu City
TUDELA MUNICIPAL HOSPITAL	----->Tudela, Misamis Occidental
TUGON MEDICAL CLINIC	----->AND HOSPITAL Pandan, Antique
TUGUEGARAO CITY PEOPLE'S	----->GENERAL HOSPITAL Tuguegarao, Tuguegarao City
TUMAUINI COMMUNITY HOSP.	----->Tumauini, Isabela
TUY GENERAL HOSPITAL	----->#6 P. Burgos St., Tuy Batangas
UERM MEMORIAL MEDICAL CENTER	----->Aurora Blvd., Sta. Mesa Quezon City
UMALI MEDICAL CLINIC	----->Gelaio Ocampo St., Pob. 1 Victoria, Oriental Mindoro
UMINGAN MEDICARE &	----->COMMUNITY HOSPITAL Umingan, Pangasinan
UNAYAN DISTRICT HOSPITAL	----->Tamparan, Lanao del Sur
UNCIANO GENERAL HOSPITAL	----->393 Boni Avenue Mandaluyong City
UNCIANO MEDICAL CENTER	----->Antipolo City
UNISAN MEDICARE	----->COMMUNITY HOSPITAL Brgy. Ilabang, Kalilayan Unisan, Quezon
UNITED BALAGTAS DOCTORS	----->HOSPITAL CORP. Wawa, Balagtas, Bulacan
UNITED CANDELARIA DOCTORS	----->HOSPITAL Candelaria, Quezon
UNITED DOCTOR'S HOSPITAL	----->OF TAGUM, INC. Tagum City, Davao del Norte
UNITED DOCTORS MEDICAL	----->CENTER 6 N. Ramirez St., Quezon City
UNITED DOCTORS MEDICAL	----->CLINIC Bunawan, Agusan Del Sur
UNITED DOCTORS HOSPITAL OF	----->KIDAPAWAN (formerly Pacifico Medical Clinic and Hospital) Quezon Avenue, Kidapawan City
UPH DR. JOSE G. TAMAYO	----->MEDICAL CENTER (formerly University of Perpetual Help Medical Center) Sto. Niño, Biñan, Laguna
UNIVERSITY HEALTH SERVICE	----->Los Baños, Laguna
UNIVERSITY OF PERPETUAL	----->HELP RIZAL  MEDICAL CENTER INC. Alabang - Zapote Rd. Las Piñas City
UNIVERSITY OF SOUTHERN	----->MINDANAO HOSPITAL USM, Kabacan, North Cotabato
UNTALAN GENERAL HOSPITAL	----->87 Gualberto Ave., Rosario Batangas
UP HEALTH SERVICES	----->UP Campus, Diliman Q. C.
URDANETA SACRED	----->HEART HOSPITAL Urdaneta City, Pangasinan
URDUJA GENERAL HOSPITAL	----->(formerly Ramos Family Clinic Inc.) Lingayen, Pangasinan
USI-MOTHER SETON HOSPITAL	----->Roxas Avenue, Naga City
UY MEDICAL CLINIC	----->Jimenez, Misamis Occidental
V. L. MAKABALI MEMORIAL	----->HOSPITAL, INC. B. Mendoza, San Fernando City Pampanga
VALDERRAMA MUNICIPAL	----->HOSPITAL Valderrama, Antique
VALDEZ MOTHER AND CHILD	----->CLINIC AND HOSPITAL Tacurong City, Sultan Kudarat
VALDEZ-PADRON HOSPITAL	----->12 Marianito St., Gulod Novaliches, Quezon City
VALENCIA MEDICAL HOSPITAL	----->Valencia City, Bukidnon
VALENCIA SANITARIUM	----->AND HOSPITAL Valencia, Bukidnon
VALENZUELA CITY EMERGENCY	----->HOSPITAL Polo, Valenzuela
VALENZUELA MEDICAL CENTER	----->Karuhatan, Valenzuela
VALERA MEDICAL HOSPITAL	----->Bangued, Abra
VALLADOLID DISTRICT HOSPITAL	----->Valladolid Street, Negros Occidental
VELASQUEZ MEDICAL CLINIC	----->AND HOSPITAL Mangatarem, Pangasinan
VELASCO HOSPITAL	----->Silang, Cavite
VETERANS MEMORIALMEDICAL CENTER	----->North Avenue, Diliman Quezon City
VETERANS REGIONAL HOSPITAL	----->Bayombong, Nueva Viscaya
VIACRUSIS MEDICAL CLINIC	----->Bansalan, Davao del Sur
VIAN FAMILY HOSPITAL	----->4041 Que Grande, Ugong Valenzuela City
VICENTE GULLAS	----->MEMORIAL HOSPITAL Banilad, Mandaue City
VICENTE GUSTILO DISTRICT	----->HOSPITAL New Escalante, Negros Occ.
VICENTE PERALTA MEMORIAL	----->DISTRICT HOSPITAL Cumadcad, Castilla, Sorsogon
VICENTE SOTTO MEMORIAL	----->MEDICAL CENTER B. Rodriguez Street, Cebu City
VIGA DISTRICT HOSPITAL	----->Viga, Catanduanes
VIGAN POLYCLINIC	----->Vigan City, Ilocos Sur
VILLABA COMMUNITY HOSPITAL	----->Suba, Villaba, Northern Leyte
VILLAFLOR'S CLINIC	----->Hilongos, Leyte
VILLAROSA HOSPITAL	----->11 Salalilla St., Project 4, Quezon City
VILLASIS POLYMEDIC HOSPITAL	----->AND TRAUMA CENTER Maharlika Highway, Poblacion Villasis, Pangasinan
VILLAVICIOSA MEDICARE AND	----->COMMUNITY HOSPITAL Villaviciosa, Abra
VINTAR DISTRICT HOSPITAL	----->Vintar, Ilocos Norte
VIRGEN MILAGROSA	----->MEDICAL CENTER San Carlos City, Pangasinan
VISAYAS COMMUNITY	----->MEDICAL CENTER Osmeña Blvd., Cebu
VSU HOSPITAL	----->Visca, Baybay, Leyte
W.G. CORTEZ MEDICAL AND	----->DIAGNOSTIC CLINIC Plazang Luma, Arayat, Pampanga
WESLEYAN UNIVERSITY PHILIPPINES	----->CARDIOVASCULAR & MEDICAL CENTER Tandang Sora St., Mabini Ext. Cabanatuan City
WEST MINDORO POLYCLINIC, INC.	----->(formerly Westmin United Doctor's Hospital) 218 Bonifacio San Jose, Occidental Mindoro
WEST VISAYAS STATE	----->UNIVERSITY MEDICAL CENTER E. Lopez St., Jaro, Iloilo City
WESTERN KALINGA	----->DISTRICT HOSPITAL Balbalan, Kalinga
WESTERN LEYTE	----->PROVINCIAL HOSPITAL Baybay, Leyte
WESTERN MINDANAO MEDICAL CENTER	----->MEDICAL CENTER, INC. Veterans Ave., Zamboanga City
WESTERN PANGASINAN	----->DISTRICT HOSPITAL Sabarro, Poblacion, Alaminos City, Pangasinan
WESTERN VISAYAS SANITARIUM	----->Sta. Barbara, Iloilo
WILFREDO C. PALMA MEMORIAL	----->HOSPITAL Poblacion, Diplahan, Zamboanga Sibugay
WORD OF HOPE GENERAL	----->HOSP. FOUNDATION INC. Novaliches, Quezon City
WORLD CITI MEDICAL CENTER	----->(formerly Quezon City Medical Center and Colleges, Inc.) 960 Aurora Blvd. Ext. Quezon City
XU COMMUNITY HOSPITAL	----->Mortola-Hayes Street Cagayan De Oro City
YUMENA HOSPITAL	----->Roxas, Isabela
YNARES MUNICIPAL HOSPITAL	----->(formerly JALA-JALA  MUNICIPAL HOSP. 474 Nat'l. Ed., Sipsipin Jala-Jala, Rizal
ZMK DOCTORS CLINIC AND	----->HOSPITAL Sto. Niño, South Cotabato
ZAEC COMMUNITY MEDICAL	----->CENTER, INC. San Jose Rd., Zamboanga City
ZAFRA MEDICAL CLINIC	----->Panabo City, Davao del Norte
ZAMBOANGA CHILDREN'S	----->HOSPITAL, INC. Pilar St., Zamboanga City
ZAMBOANGA CITY MEDICAL CENTER	----->Dr. Evangelista St. Zamboanga City
ZAMBOANGA DEL NORTE	----->COOPERATIVE HOSPITAL Dipolog City, Zamboanga Del Norte
ZAMBOANGA DEL NORTE	----->MEDICAL CENTER Dipolog City, Zamboanga Del Norte
ZAMBOANGA DEL SUR	----->MEDICAL CENTER Dao, Pagadian City
ZAMBOANGA DOCTOR'S HOSPITAL, INC.	----->Veterans Ave., Zamboanga City
ZAMBOANGA PUERICULTURE	----->LYING-IN MATERNITY & HOSPITAL Pura Brillantes St. Zamboanga City
ZAMBOANGA SIBUGAY PROVINCIAL	----->HOSPITAL Ipil, Zamboanga Sibugay
ZAPANTA GENERAL HOSPITAL	----->Pio Duran, Albay
ZAPANTA MATERNITY &	----->GENERAL HOSPITAL San Jose, Occidental Mindoro
ZARATAN-JIMENEZ MED. CLINIC	----->Aguilar, Pangasinan
ZARSONA MEDICAL CLINIC	----->Bansalan, Davao del Sur
ZENON T. LAGUMBAY	----->MEMORIAL HOSPITAL Hinundayan, Southern Leyte
ZIGA MEMORIAL DISTRICT	----->HOSPITAL Tabaco, Albay
ZIGZAG HOSPITAL	----->Mabini, Batangas
