A. ZARATE GENERAL HOSPITAL ---> Pulanglupa, Las Piñas City ---> ph
AFP MEDICAL CENTER ---> V. Luna Road, Quezon City ---> ph
ABATAN EMERGENCY ---> HOSPITAL ---> ph
ABELLA MIDWAY HOSPITAL ---> Abatan, Buguias, Benguet ---> ph
ABORLAN MEDICARE HOSPITAL ---> Valencia City, Bukidnon ---> ph
ABRA DE ILOG MUNICIPAL ---> Pob. Aborlan, Palawan ---> ph
ABRA PROVINCIAL HOSPITAL ---> HOSPITAL ---> ph
ABULUG MUNICIPAL HOSPITAL ---> Abra de Ilog, Occidental Mindoro ---> ph
ABUYOG DISTRICT HOSPITAL ---> Calaba, Bengued, Abra ---> ph
ACAS CLINIC AND HOSPITAL ---> Centro Abulug, Cagayan Valley ---> ph
ACEBEDO GENERAL HOSPITAL ---> Abuyog, Northern Leyte ---> ph
ACOSTA CLINIC ---> Vigan, Ilocos Sur ---> ph
ADELA SERRA TY MEMORIAL ---> Bagbaguin, Caloocan City ---> ph
ADVENTIST UNIVERSITY ---> Toril, Davao City ---> ph
AFABLE MEDICAL CENTER ---> Tandag, Surigao del Sur ---> ph
AGLIPAY DISTRICT HOSPITAL ---> Silang,Cavite ---> ph
AGO GENERAL HOSPITAL ---> EBB, Olongapo City ---> ph
AGOO FAMILY HOSPITAL ---> Aglipay, Quirino ---> ph
AGOO MEDICAL CLINIC ---> Rizal Street, Legaspi City ---> ph
AGPALO HOSPITAL ---> San Pedro, Agoo, La Union ---> ph
AGUINALDO PEOPLE'S ---> Agoo, La Union ---> ph
AGUSAN DEL NORTE PROVINCIAL HOSPITAL ---> GUIUAN POLYMEDIC ---> ph
AIR FORCE GENERAL HOSPITAL ---> Guiuan, Eastern Samar ---> ph
AKLAN BAPTIST HOSPITAL, INC. ---> HOSPITAL ---> ph
AKLAN COOPERATIVE MISSION Hosp ---> Aguinaldo, Ifugao ---> ph
ALABA EMERGENCY hosp ---> Libertad, Butuan City ---> ph
ALABANG MEDICAL CENTER ---> Pasay City ---> ph
ALABANG MEDICAL CLINIC ---> Caticlan, Malay, Aklan ---> ph
ALABANG MEDICAL CLINIC -MUNTINLUPA BRANCH ---> Kalibo, Aklan ---> ph
ALABANG MEDICAL CLINIC - ---> Maco, Compostela Valley ---> ph
ALABAT ISLAND DISTRICT hosp ---> Muntinlupa City ---> ph
ALAMADA PROVINCIAL ---> Alabang, Muntinlupa City ---> ph
ALAMINOS DOCTOR'S ---> No. 1 National Rd., Putatan ---> ph
ALBAY DOCTOR'S HOSPITAL ---> Muntinlupa City ---> ph
ALBINO DURAN MEMORIAL ---> Talon, Las Piñas City ---> ph
ALBOR DISTRICT HOSPITAL ---> Alabat Island, Quezon ---> ph
ALCALA MUNICIPAL HOSPITAL ---> Magsaysay, Alamada ---> ph
ALEGRE MEDICAL CLINIC ---> North Cotabato ---> ph
ALEOSAN DISTRICT HOSPITAL ---> Bolaney, Alaminos, Pangasinan ---> ph
ALEOSAN DISTRICT HOSPITAL ---> Penaranda St., Legaspi City, Albay40 ---> ph
ALFEROS HOSPITAL ---> Balangiga, Eastern Samar ---> ph
ALFONSO SPECIALISTS HOSPITAL ---> Libjo, Surigao del Norte ---> ph
ALFONSO PONCE ENRILE ---> Alcala, Cagayan Valley ---> ph
ALFREDO MARANON SR. ---> Kapalong, Davao del Norte ---> ph
ALICIA DISTRICT HOSPITAL ---> Aleosan, North Cotabato ---> ph
ALLEN DISTRICT HOSPITAL ---> Alimodian, Iloilo City ---> ph
ALMORA GENERAL HOSPITAL ---> Olongapo City ---> ph
ALTAVAS DISTRICT HOSPITAL ---> Pasig City ---> ph
ALTERADO GENERAL HOSPITAL ---> Gonzaga, Cagayan Valley ---> ph
AMAI PAKPAK MEDICAL ---> Brgy. Bato, Sagay City ---> ph
AMANG RODRIGUEZ MEDICAL CENTER ---> Negros Occidental ---> ph
AMIO COMMUNITY PRIMARY ---> Sibugay, Zamboanga ---> ph
AMISOLA MATERNITY HOSPITAL ---> Allen, Northern Samar ---> ph
AMMA JADSAC DISTRICT ---> Balunao, Tabuk ---> ph
AMOIL CLINIC AND HOSPITAL ---> Kalinga, Apayao ---> ph
AMOROSO MEDICAL CLINIC ---> Altavas, Aklan ---> ph
AMOSUP SEAMEN'S ---> R. Castillo St., Agdao ---> ph
AMOSUP SEAMEN'S ---> Davao City ---> ph
ANAHAWAN DISTRICT HOSPITAL ---> CENTER ---> ph
ANDOT MEDICAL CLINIC ---> Marawi City, Lanao del Sur ---> ph
ANDRES SORIANO MEMORIAL ---> Sumulong Highway, Marikina City ---> ph
ANGEL SALAZAR MEMORIAL ---> HOSPITAL ---> ph
ANGELES MEDICAL CENTER ---> Sta. Catalina, Negros Oriental ---> ph
ANGELES UNIVERSITY ---> 1068 Hermosa Street, ---> ph
ANGONO GENERAL HOSPITAL ---> Tondo Manila ---> ph
ANGONO MEDICS HOSPITAL ---> HOSPITAL ---> ph
ANICETO T. PESANTE SR. ---> Pudtol, Kalinga, Apayao ---> ph
ANN FRANCIS MATERNITY HOSPITAL ---> Brgy. J. C. Montilla, Tacurong ---> ph
ANTEQUERA COMMUNITY ---> Sultan Kudarat ---> ph
ANTIPAS MEDICAL SPECIALIST ---> Imelda, Zamboanga Sibugay ---> ph
ANTIPOLO CITY MEDICAL ---> HOSPITAL - CEBU ---> ph
ANTIPOLO DISTRICT HOSPITAL ---> Mandaue City, Cebu ---> ph
ANTIPOLO DOCTORS HOSPITAL ---> HOSPITAL - ILOILO ---> ph
ANTONIO D. FLORENDO HOSPITAL ---> Mandurriao, Iloilo City ---> ph
ANULAO ST. M.ICHAEL MEDICAL ---> Anahawan, Southern Leyte ---> ph
APACIBLE MEMORIAL ---> Bacolod, Lanao Del Norte ---> ph
APALIT DOCTORS HOSPITAL ---> HOSPITAL COOPERATIVE ---> ph
APARRI MEDICARE COMMUNITY ---> Tabon, Bislig, Surigao del Sur ---> ph
APARRI PROVINCIAL HOSPITAL ---> GENERAL HOSPITAL ---> ph
APAYAO DISTRICT HOSPITAL ---> Brgy. Atabay, San Jose ---> ph
APAYAO PROVINCIAL HOSPITAL ---> Antique ---> ph
AQUINAS UNIVERSITY HOSPITAL ---> Rizal St., Angeles City ---> ph
ARAKAN VALLEY DISTRICT ---> FOUNDATION MEDICAL CENTER ---> ph
ARAYAT MEDICAL & ---> McArthur Hi-way ---> ph
ARMY STATION HOSPITAL ---> Angeles City ---> ph
ARNAIZ HOSPITAL ---> Angono, Rizal ---> ph
AROROY MUNICIPAL HOSPITAL ---> Angono, Rizal ---> ph
ARSENAL "KALUSUGAN" ---> MEMORIAL HOSPITAL ---> ph
ARTECHE DISTRICT HOSPITAL ---> Midsayap, North Cotabato ---> ph
ARUELO GENERAL HOSPITAL ---> 606 Quirino Highway ---> ph
ASANIAS POLYCLINIC ---> Novaliches, Quezon City ---> ph
ASIA MEDIC FAMILY HOSPITAL ---> HOSPITAL ---> ph
ASIAH MEDICAL HOSPITAL ---> Antequera, Bohol ---> ph
ASIAN HOSPITAL AND MEDICAL CENTER ---> HOSPITAL, INC. ---> ph
ASILO HOSPITAL ---> (former CLINICA CATOTAL) ---> ph
ASINGAN MEDICARE & ---> Antipas, North Cotabato ---> ph
ASSCOM - DLSUMC ---> HOSPITAL ---> ph
ASSUMPTA MEDICAL HOSPITAL ---> Sumulong Highway, Antipolo City ---> ph
ATOK DISTRICT HOSPITAL ---> Bagong Nayon2, Antipolo City ---> ph
AUGUIS CLINIC AND HOSPITAL ---> Antipolo City ---> ph
AURORA GENERAL HOSPITAL ---> Tadeco, Panabo City ---> ph
AURORA MEMORIAL HOSPITAL ---> Davao del Norte ---> ph
AZNAR MEDICAL CLINIC ---> CLINIC & HOSPITAL ---> ph
BBCSS PEDIATRIC MEDICAL ---> Cabacan, North Cotabato ---> ph
BABAK COMMUNITY HOSPITAL ---> DISTRICT HOSPITAL ---> ph
BABARAN-ECHAVEZ MEDICAL ---> Nasugbu, Batangas ---> ph
BABOL GENERAL HOSPITAL ---> Apalit, Pampanga ---> ph
BACNOTAN DISTRICT HOSPITAL ---> HOSPITAL ---> ph
BACOLOD ADVENTIST ---> Bangag, Aparri, Cagayan ---> ph
BACOLOD OUR LADY OF MERCY SPECIALIST HOSPITAL ---> Toran Aparri, Cagayan ---> ph
BACONAWA HOSPITAL ---> Calanasan, Mabubua, Apayao ---> ph
BADIAN DISTRICT HOSPITAL ---> (formerly Kabugao District Hosp.) ---> ph
BAESA ADVENT POLYCLINIC ---> Kabugao, Kalinga, Apayao ---> ph
BAGAC MEDICARE & COMMUNITY HOSPITAL ---> Washington Drive, Legaspi City ---> ph
BAGGAO MEDICARE ---> HOSPITAL ---> ph
BAGGAO MUNICIPAL HOSPITAL ---> Arakan, North Cotabato ---> ph
BAGO CITY HOSPITAL ---> OB-GYNE CLINIC ---> ph
BAGONG CAINTA MUNICIPAL ---> Brgy. Mangga, Cacutud ---> ph
BAGTILAY ADULT SPECIALTY ---> Arayat, Pampanga ---> ph
BAGUIO FILIPINO CHINESE ---> (formerly Camp Capinpin ---> ph
BAGUIO GENERAL HOSPITAL ---> Station Hospital) ---> ph
BAGUIO MEDICAL CENTER ---> Brgy. Sampaloc Tanay, Rizal ---> ph
BAILAN DISTRICT HOSPITAL ---> Cainta, Rizal ---> ph
BAIS DISTRICT HOSPITAL ---> Aroroy, Masbate ---> ph
BAKING MEDICAL CENTER ---> HOSPITAL ---> ph
BALAMBAN DISTRICT HOSPITAL ---> Lamao, Limay, Bataan ---> ph
BALIBAGO POLYCLINIC ---> Arteche, Eastern Samar ---> ph
BALINDONG DISTRICT ---> Tangub City, Misamis Occidental ---> ph
BALITUCAN DISTRICT HOSPITAL ---> Sanchez Mira, Cagayan ---> ph
BALIUAG DISTRICT HOSPITAL ---> AND MEDICAL CLINIC ---> ph
BALLESTEROS DISTRICT HOSPITAL ---> Dasmariñas, Cavite ---> ph
BALLESTEROS MATERNITY ---> San Pedro Dist., Pagadian City ---> ph
BALO-I PROVINCIAL HOSPITAL ---> MEDICAL CENTER ---> ph
BALUD MUNICIPAL HOSPITAL ---> 2205 Civic Drive, Centennial Lane ---> ph
BANEZ HOSPITAL ---> Filinvest Corporate City ---> ph
BANGUED CHRISTIAN HOSPITAL ---> Alabang, Muntinlupa City ---> ph
BANGUI DISTRICT HOSPITAL ---> Padada, Davao del Sur ---> ph
BANSALAN MEDICAL CLINIC ---> COMMUNITY HOSPITAL ---> ph
BANTAYAN DISTRICT HOSPITAL ---> Asingan, Pangasinan ---> ph
BARILI DISTRICT HOSPITAL ---> FRIENDSHIP HOSPITAL ---> ph
BARLIG DISTRICT HOSPITAL ---> San Juan, Apalit, Pampanga ---> ph
BARON-YEE HOSPITAL ---> Taal, Batangas ---> ph
BAROTAC VIEJO DSTRICT ---> Sayangan, Atok, Benguet ---> ph
BASA AIR BASE HOSPITAL ---> Gen. Santos City ---> ph
BASEY DISTRICT HOSPITAL ---> Aurora, Zamboanga del Sur ---> ph
BASILAN COMMUNITY ---> Baler, Aurora ---> ph
BASILAN GEN. HOSPITAL ---> Maramag, Bukidnon ---> ph
BATAAN DOCTOR'S HOSPITAL ---> & SURGICAL CLINIC ---> ph
BATAAN GENERAL HOSPITAL ---> Cauayan City, Isabela ---> ph
BATAAN PENINSULA ---> Babak, Davao del Norte ---> ph
BATAAN ST. JOSEPH HOSPITAL ---> AND PSYCHIATRIC CLINIC ---> ph
BATAAN WOMEN'S HOSPITAL INC. ---> 1125 Amparo St., Poblacion ---> ph
BATANES GENERAL HOSPITAL ---> Muntinlupa City ---> ph
BATANGAS HEALTHCARE HOSPITAL ---> Matalam, North Cotabato ---> ph
BATANGAS REGIONAL HOSPITAL ---> Bacnotan, La Union ---> ph
BATO MATERNITY AND ---> MEDICAL CENTER ---> ph
BAUAN DOCTORS GEN. HOSPITAL ---> Taculing, Bacolod City ---> ph
BAUAN GENERAL HOSPITAL ---> MERCY SPECIALTY HOSP. ---> ph
BAUTISTA HOSPITAL ---> Eureco, Mandalagan ---> ph
BAYAMBANG DISTRICT HOSPITAL ---> Bacolod City, Negros Occidental ---> ph
BAYAWAN DISTRICT HOSPITAL ---> Rizal St., Llorente,Eastern Samar ---> ph
BAYUGAN COMMUNITY HOSPITAL ---> Badian, Cebu City ---> ph
BAYUGAN J.M. YAP STO. NIÑO ---> AND GENERAL HOSPITAL ---> ph
BEATO CAUILAN HOSPITAL ---> 238 Deparo St., Baesa ---> ph
BENDIJO HOSPITAL (former St. Anthony ---> Caloocan City ---> ph
BENGUET GENERAL HOSPITAL ---> Brgy. Atilano Ricardo, Bagac ---> ph
BERACHAH MEDICAL CLINIC ---> Bataan ---> ph
BERMUNDEZ POLYMEDIC HOSPITAL ---> COMMUNITY HOSPITAL ---> ph
BERNARDINO GENERAL HOSPITAL I ---> Baggao, Cagayan Valley ---> ph
BERNARDINO GENERAL HOSPITAL II ---> Tallang, Baggao, Cagayan ---> ph
BESSANG PASS MEMORIAL ---> Bago City, Negros Occidental ---> ph
BESSAO DISTRICT HOSPITAL ---> HOSPITAL ---> ph
BETHANY HOSPITAL ---> Sto. Domingo, Cainta Rizal ---> ph
BETHANY HOSPITAL, INC. ---> CLINIC AND HOSPITAL ---> ph
BETHEL BAPTIST HOSPITAL, INC. ---> San Isidro, Isabela ---> ph
BICOL MEDICAL CENTER ---> GENERAL HOSPITAL ---> ph
BICOL REGIONAL TRAINING ---> Trancoville, Baguio City ---> ph
BICOL SANITARIUM ---> & MEDICAL CENTER ---> ph
BILIRAN PROVINCIAL HOSPITAL ---> Gov. Park Rd., Baguio City ---> ph
BINALBAGAN INFIRMARY ---> 9 Military Cut-off Road ---> ph
BIÑAN DOCTOR'S HOSPITAL, INC. ---> Baguio City ---> ph
BINDOY DISTRICT HOSPITAL ---> Bailan, Pontevedra, Capiz ---> ph
BIRHEN SA REGLA MEDICAL ---> Bais City, Negros Oriental ---> ph
BIRI DISTRICT HOSPITAL ---> Minglanilla, Cebu City ---> ph
BISHOP JOSEPH REAGAN ---> Balamban, Cebu ---> ph
BISLIG DISTRICT HOSPITAL ---> AND HOSPITAL ---> ph
BLANCIA HOSPITAL ---> Sta. Rosa, Laguna ---> ph
BLESSED FAMILY DOCTORS ---> HOSPITAL ---> ph
BLESSED TRINITY MATERNITY ---> Balindong, Lanao del Sur ---> ph
BOGO MEDELLIN MEDICAL CENTER ---> San Pablo, Magalang, Pampanga ---> ph
BOHOL SAINT JOSEPH CLINIC ---> Sabang Baliuag,Bulacan ---> ph
BOHOL ST. JOHN ---> Ballesteros, Cagayan Valley ---> ph
BOHOL ST. JUDE HOSPITAL ---> AND LYING-IN CLINIC ---> ph
BOISER MEDICAL CLINIC ---> Centro East, Ballesteros ---> ph
BOLINAO MEDICARE ---> Cagayan ---> ph
BONDOC PENINSULA ---> Balo-I, Lanao Del Norte ---> ph
BONGABON DISTRICT HOSPITAL ---> Balud, Masbate ---> ph
BONGABONG COMMUNITY ---> (former BAÑEZ CLINIC) ---> ph
BONGAO DOCTOR'S HOSPITAL ---> Carmen, Rosales, Pangasinan ---> ph
BONGCAS HOLY CHILD ---> Torrijos St., Bangued, Abra ---> ph
BONIFACIO MEDICAL CLINIC ---> Bangui, Ilocos Norte ---> ph
BONTILAO'S COUNTRY CLINIC ---> Bansalan, Davao del Sur ---> ph
BONTOC GENERAL HOSPITAL ---> Bantayan Island, Cebu ---> ph
BONTUYAN MEDICAL CLINIC ---> Barili, Cebu ---> ph
BORBON GENERAL HOSPITAL ---> Barlig, Mt. Province ---> ph
BORJA FAMILY HOSPITAL ---> Padada, Davao Del Sur ---> ph
BORONGAN DOCTORS' ---> HOSPITAL ---> ph
BRENT HOSPITAL & COLLEGES, INC. ---> Barotac Viejo, Iloilo ---> ph
BRIGADIER GEN. BENITO EBUEN ---> Floridablanca, Pampanga ---> ph
BROKENSHIRE INTEGRATED ---> Basey, Western Samar ---> ph
BUCAG'S HOSPITAL ---> HOSPITAL, INC ---> ph
BUCAY MUNICIPAL HOSPITAL ---> Isabela City, Basilan ---> ph
BUDA COMMUNITY HEALTH CARE CENTER ---> Basilan, Isabela ---> ph
BUENAVISTA EMERGENCY HOSPITAL ---> Dona Francisca Subd. ---> ph
BUGALLON GENERAL HOSPITAL ---> Balanga City, Bataan ---> ph
BUGASONG MEDICARE ---> Balanga, Tenejero Bataan ---> ph
BUKIDNON COMMUNITY ---> Tenejero, Balanga ---> ph
BUKIDNON PROVINCIAL ---> MEDICAL CENTER ---> ph
BUKIDNON PROVINCIAL ---> Dinalupihan, Bataan ---> ph
BUKIDNON PROVINCIAL ---> Don Manuel Banzon St. ---> ph
BUKIDNON PROVINCIAL HOSP.- ---> Balanga, Bataan ---> ph
BUKIDNON PROVINCIAL HOSPITAL- ---> St. Joseph Subd., Balanga City ---> ph
BUKIDNON PROVINCIAL HOSP. ---> Basco, Batanes ---> ph
BUKIDNON PROVINCIAL HOSP.- ---> (former Jesus Nazarene Medical Center) ---> ph
BUKIDNON PROVINCIAL HOSPITAL- ---> Brgy. Gulod Itaas, Batangas City ---> ph
BULACAN MATERNITY & ---> Batangas City ---> ph
BULACAN MEDICAL CENTER ---> CHILDREN'S HOSPITAL ---> ph
BULACAN MEDICAL MISSION ---> Bato, Catanduanes ---> ph
BULACAN POLYMEDIC HOSPITAL ---> Bauan, Batangas ---> ph
BULALACAO COMMUNITY HOSPITAL ---> Bauan, Batangas ---> ph
BULAN MUNICIPAL HOSPITAL ---> Caridad, Cavite City ---> ph
BULLECER MEDICAL CLINIC ---> Bayambang, Pangasinan ---> ph
BULUAN DISTRICT HOSPITAL ---> Bayawan, Negros Oriental ---> ph
BULUSAN FAMILY CLINIC ---> Bayugan, Agusan del Sur ---> ph
BUNAWAN DISTRICT HOSPITAL ---> HOSPITAL ---> ph
BUNGABONG-SANICO ---> Rotunda, Bayugan ---> ph
BURAUEN DISTRICT HOSPITAL ---> Agusan del Sur ---> ph
BURUANGA MUNICIPAL HOSPITAL ---> Villa Carolina I, National Highway ---> ph
BUSTOS COMMUNITY HOSPITAL ---> Tunasan, Muntinlupa City ---> ph
BUTUAN DOCTORS' HOSPITAL, INC. ---> General Hospital) ---> ph
BUTUAN MEDICAL CENTER ---> Hagonoy, Davao del Sur ---> ph
BUTUAN PUERICULTURE CENTER ---> Km. 5, La Trinidad, Benguet ---> ph
C & H MEDICAL AND SURGICAL CLINIC ---> Nat'l. Hi-way, Brooke's Point ---> ph
C.M. RECTO MEMORIAL ---> Palawan ---> ph
C.P. REYES HOSPITAL ---> Tala, Kalookan City ---> ph
CABA MEDICARE  ---> 680 Quirino Highway, Sn. ---> ph
CABADBARAN DISTRICT HOSP. ---> Bartolome, Novaliches ---> ph
CABANGAN INFIRMARY ---> Quezon City ---> ph
CABATUAN FAMILY CLINIC ---> North Olympus Subd. ---> ph
CABIAO GENERAL HOSPITAL, INC. ---> Quezon City ---> ph
CABINTE MATERNITY AND ---> HOSPITAL ---> ph
CABREDO GENERAL HOSPITAL ---> Cervantes, Ilocos Sur ---> ph
CADIZ DISTRICT HOSPITAL ---> Bessao, Mt. Province ---> ph
CADULONG MEDICAL CLINIC ---> Real St., Tacloban City ---> ph
CAGAYAN DE ORO MATERNITY ---> San Fernando City, La Union ---> ph
CAGAYAN DE ORO MEDICAL CENTER, INC. ---> Sumpang, Malaybalay ---> ph
CAGAYAN DE ORO POLYMEDIC ---> Malaybalay City ---> ph
CAGAYAN DE ORO POLYMEDIC ---> Concepcion Pequeña Sr. ---> ph
CAGAYAN DE TAWI-TAWI ---> Naga City, Camarines Sur ---> ph
CAGAYAN VALLEY MEDICAL CENTER ---> AND TEACHING HOSPITAL ---> ph
CAGAYAN VALLEY ADVENTIST ---> Rizal St., Legaspi City, Albay ---> ph
CAGRARAY DISTRICT HOSPITAL ---> Cabusao, Camarines Sur ---> ph
CAINGLET MEDICAL CLINIC ---> Naval, Biliran ---> ph
CALALANG GENERAL HOSPITAL ---> Rizal, Binalbagan ---> ph
CALAMBA DISTRICT HOSPITAL ---> Negros Occidental ---> ph
CALAMBA DOCTOR'S HOSPITAL ---> Platero, Biñan, Laguna ---> ph
CALAMBA MEDICAL CENTER ---> Bindoy, Negros Oriental ---> ph
CALATAGAN MEDICARE HOSPITAL ---> CLINIC ---> ph
CALATRAVA DISTRICT HOSPITAL ---> Tulunan, North Cotabato ---> ph
CALBAYOG DISTRICT HOSPITAL ---> Biri, Northern Samar ---> ph
CALBAYOG SANITARIUM AND HOSPITAL ---> MEMORIAL HOSPITAL ---> ph
CALLANG GENERAL HOSPITAL ---> Christ the King, Tagum City ---> ph
CALLEJO MEDICAL CLINIC ---> Bislig, Surigao del Sur ---> ph
CAMARINES NORTE ---> Molave, Zamboanga del Sur ---> ph
CAMIGUIN GENERAL HOSPITAL ---> GENERAL HOSPITAL ---> ph
CAMP AQUINO STATION HOSPITAL ---> San Carlos City, Pangasinan ---> ph
CAMP BRIG.GEN. SALIPADA ---> & MEDICAL HOSPITAL ---> ph
CAMP EVANGELISTA STATION ---> Unit I Bufer Bldg. Avatec Road ---> ph
CAMP GENERAL ARTEMIO ---> Marcos Highway, Mayamot ---> ph
CAMP GEN. EMILIO AGUINALDO ---> Antipolo City ---> ph
CAMP LAPU-LAPU ARMY ---> Medellin, Cebu ---> ph
CAMP LUKBAN STATION HOSPITAL ---> Tubigon, Bohol ---> ph
CAMP MELCHOR F. DELA CRUZ ---> COMMUNITY HOSPITAL ---> ph
CAMP NAKAR STATION HOSPITAL ---> Nar. Hi-way, Canaya-on ---> ph
CAMP NAVARRO GEN. HOSPITAL ---> Garcia Hernandez, Bohol ---> ph
CAMP PANACAN STATION ---> Tagbilaran City ---> ph
CAMP PERALTA STATION HOSPITAL ---> Sto. Tomas, Daval del Norte ---> ph
CAMP SIONGCO STATION HOSPITAL ---> COMMUNITY HOSPITAL ---> ph
CAN - AVID MUNICIPAL HOSPITAL ---> Bolinao, Pangasinan ---> ph
CANDELARIA DISTRICT ---> DISTRICT HOSPITAL ---> ph
CANDELARIA MUNICIPAL ---> Catanauan,Quezon ---> ph
CANDIJAY MEDICARE ---> Curva, Bongabon, Nueva Ecija ---> ph
CANDON GENERAL HOSPITAL ---> HOSPITAL ---> ph
CANLAON DISTRICT HOSPITAL ---> Bongabong, Oriental Mindoro ---> ph
CAPAZ MULTI-SPECIALTY HOSP. ---> (formerly Tawi-Tawi Doctor's Hospital) ---> ph
CAPITOL MEDICAL CENTER ---> Brgy. Mampallan, Bongao, Tawi-Tawi12 ---> ph
CAPITOL UNIVERSITY MEDICAL ---> HOSPITAL ---> ph
CAPIZ DOCTOR'S HOSPITAL ---> Poblacion, Maramag, Bukidnon ---> ph
CAPIZ EMMANUEL HOSP., INC. ---> Bonifacio, Misamis Occidental ---> ph
CAPT. RUPERTO LUZON ---> Maranding, Lala, ---> ph
CAPUL DISTRICT HOSPITAL ---> Lanao Del Norte ---> ph
CARAGA HOSPITAL INFANT ---> Bontoc, Mt. Province ---> ph
CARAGA REGIONAL HOSPITAL ---> Polomolok, South Cotabato ---> ph
CARAMOAN MUNICIPAL ---> Pagadian City, Zamboanga del Sur 15 ---> ph
CARAMORAN MUNICIPAL ---> CORPORATION ---> ph
CARDINAL SANTOS MEDICAL CENTER ---> Tagbilaran City ---> ph
CARIGARA DISTRICT HOSPITAL ---> HOSPITAL ---> ph
CARLITO O. ALVIZO AND ---> Borongan, Eastern Samar ---> ph
CARLOS MEDICAL AND ---> R.T. Lim Blvd., Zamboanga City ---> ph
CARMEN COPPER CORP. HOSPITAL ---> AIR BASE HOSPITAL ---> ph
CARMEN DISTRICT HOSPITAL ---> Lapu-Lapu City ---> ph
CARMEN MEDICAL CLINIC & ---> HEALTH MINISTRIES, INC. ---> ph
CARMELITE HOSPITAL ---> Madapo Hills, Davao City ---> ph
CARRANGLAN MEDICARE & ---> Cauayan City, Isabela ---> ph
CASAUL GENERAL HOSPITAL, INC. ---> Siblong, Bucay, Abra ---> ph
CASIGURAN DISTRICT HOSPITAL ---> Marilog Dist. Davao City ---> ph
CASTRO MATERNITY & GENERAL ---> Mac Lain, Buenavista, Guimaras ---> ph
CATAINGAN DISTRICT HOSPITAL ---> AND DIABETES CENTER ---> ph
CATALAN MEDICAL HOSPITAL ---> Bugallon, Pangasinan ---> ph
CATARMAN DISTRICT HOSPITAL ---> COMMUNITY HOSPITAL ---> ph
CATEEL DISTRICT HOSPITAL ---> Bugasong, Antique ---> ph
CATIGBIAN DISTRICT HOSPITAL ---> HEALTH CARE CENTER ---> ph
CATUBIG DISTRICT HOSPITAL ---> Fortich St., Purok 15 ---> ph
CAUAYAN DISTRICT HOSPITAL ---> Valencia City, Bukidnon ---> ph
CAUAYAN FAMILY HOSPITAL ---> HOSPITAL - KIBAWE ---> ph
CAUAYAN MEDICAL SPECIALIST ---> Kibawe, Bukidnon ---> ph
CAUAYAN MUNICIPAL HOSPITAL ---> HOSPITAL - KALILANGAN ---> ph
CAVITE MEDICAL CENTER ---> West Pob., Kalilangan, Bukidnon ---> ph
CAVITE MUNICIPAL HOSPITAL ---> HOSPITAL - MALITBOG ---> ph
CAVITE NAVAL HOSPITAL ---> Malitbog, Bukidnon ---> ph
CAWAYAN MUNICIPAL HOSPITAL ---> MANOLO FORTICH ---> ph
CEBU CITY MEDICAL CENTER ---> Manolo Fortich, Bukidnon ---> ph
CEBU DOCTORS' HOSPITAL ---> MARAMAG BUKIDNON ---> ph
CEBU NORTH GENERAL HOSPITAL ---> North Poblacion, Maramag ---> ph
CEBU PUERICULTURE CENTER ---> Bukidnon ---> ph
CEBU SOUTH GENERAL HOSPITAL ---> (IPHO) of MALAYBALAY CITY ---> ph
CEBU VELEZ GEN. HOSPITAL, INC. ---> Malaybalay City, Bukidnon ---> ph
CEFERINO L. JIMENEZ CHILD CLINIC ---> SAN FERNANDO ---> ph
CENTENO MEDICAL SPECIALISTS ---> San Fernando, Bukidnon ---> ph
CENTRAL AZUCARRERA ---> TALAKAG ---> ph
CENTRAL ILOCOS SUR DISTRICT ---> Talakag, Bukidnon ---> ph
CENTRAL LUZON DOCTORS ---> CHILDREN HOSPITAL ---> ph
CENTRAL LUZON STATE ---> (formerly Calumpit District Hospital) ---> ph
CENTRAL MINDANAO ---> Canlogan, Calumpit, Bulacan ---> ph
CEREVILLE MEDICAL CLINIC ---> Majon, Malolos, Bulacan ---> ph
CHARLES W. SELBY MEMORIAL ---> GROUP PHARMACY & ---> ph
CHAVEZ MEDICAL CLINIC ---> HOSPITAL - TURO BRANCH ---> ph
CHILDREN'S MEDICAL HOSPITAL ---> Bocaue, Bulacan ---> ph
CHINESE GENERAL HOSPITAL ---> # 113 Cagayan Valley Road ---> ph
CHONG HUA HOSPITAL ---> Sta Cruz, Guiguinto, Bulacan ---> ph
CHRISTIAN GENERAL HOSPITAL ---> Bulalacao, Oriental Mindoro ---> ph
CHRIST THE KING ---> Mojon, Bulan, Sorsogon ---> ph
CICOSAT HOSPITAL ---> Toril, Davao City ---> ph
CITY OF CANDON HOSPITAL ---> Buluan, Maguindanao ---> ph
CIUDAD MEDICAL ZAMBOANGA ---> Bulusan, Sorsogon ---> ph
CLARIN COMMUNITY HOSPITAL ---> Bunawan, Agusan del Sur ---> ph
CLARK AIRBASE HOSPITAL ---> MEDICAL HOSPITAL ---> ph
CLARK CENTRAL MEDICAL CENTER ---> Sto. Tomas, Davao del Norte ---> ph
CLAVERIA DISTRICT HOSPITAL ---> Burauen, NorthernLeyte ---> ph
CLINICA ARELLANO ---> Buruanga, Aklan ---> ph
CLINICA DE LEON ---> Bustos, Bulacan ---> ph
CLINICA FELICIANO II ---> J. C. Aquino Ave.,Butuan City ---> ph
CLINICA GATCHALIAN AND HOSPITAL ---> Km 5 Baan, Butuan City ---> ph
CLINICA HENSON ---> No. 394 INC ELISA R.OCHOA ---> ph
CLINICA ISAGUIRRE ---> MEMORIAL MATERNITY ---> ph
CLINICA JESUS NAZARENO ---> & GEN. HOSPITAL ---> ph
CLINICA LUNTAO AND HOSPITAL ---> 702 San Jose St., Butuan City ---> ph
CLINICA OZARAGA ---> Alaminos City, Pangasinan ---> ph
CLINICA PINEDA ---> DISTRICT HOSPITAL ---> ph
CLINICA RUDINAS & HOSPITAL ---> Rizal St., Infanta, Quezon ---> ph
CLINICA STA. TERESA ---> Tanauan, Batangas ---> ph
CODILLA-RAMOS CLINIC AND HOSPITAL ---> COMMUNITY HOSPITAL ---> ph
COL. DOMINGO A. VALDEZ ---> Caba, La Union ---> ph
COMMUNITY HEALTH AND ---> Cabadbaran, Agusan del Norte ---> ph
COMMUNITY GENERAL HOSPITAL ---> Dolores, Cabangan Zambales ---> ph
COMMUNITY MEDICAL CLINIC ---> AND HOSPITAL ---> ph
COMPOSTELA VALLEY HOSPITAL ---> Cabatuan, Isabella ---> ph
COMPOSTELA VALLEY ---> San Fernando Sur, Cabiao ---> ph
CONCEPCION DISTRICT HOSPITAL ---> Nueva Ecija ---> ph
CONG. LAMBERTO C. MACIAS ---> CHILDREN'S' HOSPITAL ---> ph
CONG. NATALIO P. CASTILLO ---> Talon 5, Las Pinas City ---> ph
CONG. SIMEON G. TORIBIO ---> Tabaco City, Albay ---> ph
CONNER DISTRICT HOSPITAL ---> Hortencia, Cadiz City, ---> ph
CONSUELO TAN MEMORIAL ---> Negros Occidental ---> ph
CONTRERAS MEDICAL CLINIC ---> Roxas, North Cotabato ---> ph
CORADO MEDICAL CLINIC ---> CHILDREN'S HOSPITAL AND ---> ph
CORAZON LOCSIN MONTELIBANO ---> PUERICULTURE CENTER ---> ph
CORON DISTRICT HOSPITAL ---> Tiano Justo Gaerlan Street ---> ph
CORPUZ CLINIC AND HOSPITAL ---> Cagayan De Oro City ---> ph
CORROMPIDO SPECIALTY HOSPITAL ---> Tiano-Nacalaban St. ---> ph
CORTES MUNICIPAL HOSPITAL ---> Cagayan de Oro City ---> ph
COTABATO MEDICAL ---> GENERAL HOSPITAL ---> ph
COTABATO PROVINCIAL HOSPITAL (IPHO) ---> Don Apolinario Velez St. ---> ph
COTABATO PUERRICULTURE CENTER ---> Cagayan de Oro City ---> ph
COTABATO REGIONAL HOSPITAL ---> MEDICAL PLAZA ---> ph
COTABATO SANITARIUM HOSPITAL ---> Kauswagan, ---> ph
CRISOSTOMO GENERAL HOSPITAL ---> Cagayan De Oro City ---> ph
CRISTINO PARAGAS MEMORIAL ---> DISTRICT HOSPITAL ---> ph
CRUZ-DALIDA MATERNITY ---> Brgy. Lupa Lupa Mapun,Tawi-Tawi ---> ph
CRUZ RABE GENERAL HOSPITAL ---> Carig, Tuguegarao, Cagayan ---> ph
CRUZADO MEDICAL CLINIC ---> HOSPITAL INC. ---> ph
CUARTERO GENERAL HOSPITAL ---> Santiago City, Isabela ---> ph
CUISON HOSPITAL, INC. ---> Cabasan, Bacacay, Albay ---> ph
CULASI DISTRICT HOSPITAL ---> Panabo, Davao del Norte ---> ph
CULION SANITARIUM ---> 16R Valenzuela St., McArthur ---> ph
CUYO DISTRICT HOSPITAL ---> H-way, Marulas,Valenzuela City ---> ph
D.B.B. MUNICIPAL HOSPITAL ---> Calamba, Misamis Occidental ---> ph
D.H. POLINTAN MEDICAL CLINIC ---> Parian, Calamba City, Laguna ---> ph
D.O. PLAZA MEMORIAL HOSPITAL ---> Calamba City, Laguna ---> ph
D. T. PROTACIO HOSPITAL ---> Calatagan, Batangas ---> ph
DAANBANTAYAN DISTRICT HOSPITAL ---> Calatrava, Negros Occidental ---> ph
DAGUPAN DOCTORS VILLAFLOR ---> Calbayog City, Western Samar ---> ph
DAGUPAN ORTHOPEDIC CENTER ---> Calbayog City, Western Samar ---> ph
DANAO DISTRICT HOSPITAL ---> Santiago City, Isabela ---> ph
DANAO MOTHER AND CHILD HOSPITAL ---> 545-A Talon Garden ---> ph
DANAO SALE MEDICAL CLINIC ---> Las Piñas City ---> ph
DANIEL MERCADO MEDICAL ---> PROVINCIAL HOSPITAL ---> ph
DATU BLAH T. SINSUAT DISTRICT ---> Daet, Camarines Norte ---> ph
DATU HALUN SAKILAN ---> Mambajao, Camiguin ---> ph
DAVAO ADVENTIST HOSPITAL ---> Camp Aquino, Northern Luzon ---> ph
DAVAO DEL SUR PROVINCIAL ---> Command, San Miguel, Tarlac ---> ph
DAVAO DOCTORS HOSPITAL ---> K. PENDATUN HOSPITAL ---> ph
DAVAO MEDICAL SCHOOL ---> Camp. BGSKP, Parang, ---> ph
DAVAO MEDIQUEST HOSP. INC. ---> Maguindanao ---> ph
DAVAO ORIENTAL PROVINCIAL ---> HOSPITAL 4th ID PA ---> ph
DAVAO REGIONAL HOSPITAL ---> Patag, Cagayan de Oro City ---> ph
DAYOS-PASCUAL MEDICAL CLINIC ---> RICARTE STATION HOSPITAL ---> ph
DE CASTRO HOSPITAL ---> Pto. Princesa City, Palawan ---> ph
DE JESUS GENERAL HOSPITAL ---> STATION HOSPITAL ---> ph
DE OCAMPO MEMORIAL MEDICAL CENTER ---> Camp. Gen. E. Aguinaldo ---> ph
DE VERA'S MEDICAL CENTER ---> Murphy, Cubao, Quezon City ---> ph
DECENA GENERAL HOSPITAL ---> STATION HOSPITAL ---> ph
DEE HWA LIONG FOUNDATION ---> Lahug, Cebu ---> ph
DEIPARINE MEDICAL CLINIC ---> Catbalogan, Samar ---> ph
DEL CARMEN DISTRICT HOSPITAL ---> STATION HOSPITAL ---> ph
DEL CARMEN MEDICAL CLINIC ---> Camp MPI, Gamu, Isabela ---> ph
DEL CARMEN MEDICAL CLINIC ---> Camp Guillermo Nakar ---> ph
DEL MONTE BUGO CLINIC ---> Lucena City, Quezon ---> ph
DELA CERNA MEDICAL CLINIC ---> Upper Calarian, Zamboanga City ---> ph
DELA CRUZ MATERNITY HOSPITAL ---> HOSPITAL SOUTHERN AFP ---> ph
DELA SALLE UNIVERSITY ---> Camp Panacan, Davao City ---> ph
DELA SALLE UNIVERSITY- DR. ---> Camp Peralta, Jr., 3rd Infanty ---> ph
DELBERT JON'S POLYCLINIC ---> (Spearhead) Div. PA, Jamindan, ---> ph
DELFIN ALBANO COMMUNITY HOSPITAL ---> Capiz ---> ph
DELOS SANTOS - STI MEDICAL CENTER ---> CP B. Gen. Gonzalo H. ---> ph
DELOS REYES MEDICAL CLINIC ---> Siongco, Awang, Maguindanao ---> ph
DEMANO'S MEDICAL AND ---> Can-Avid, Eastern Samar ---> ph
DENNIS MOLINTAS MUNICIPAL ---> HOSPITAL ---> ph
DETECIO COMMUNITY HOSPITAL ---> Yamat, Candelaria, Zambales ---> ph
DIFFUN DISTRICT HOSPITAL ---> HOSPITAL ---> ph
DIGNUM FOUNDATION ---> Candelaria, Quezon ---> ph
DIGOS DOCTOR'S HOSP., INC. ---> COMMUNITY HOSPITAL ---> ph
DIHMESCO GENERAL HOSPITAL ---> Candijay, Bohol ---> ph
DIMIAO MUNICIPAL INFIRMARY ---> Candon, Ilocos Sur ---> ph
DINAGAT DISTRICT HOSPITAL ---> Canlaon City, Negros Oriental ---> ph
DINAIG MUNICIPAL HOSPITAL ---> M.H. Del Plar St., Sto. Rosario ---> ph
DINGRAS DISTRICT HOSPITAL ---> Capaz, Tarlac ---> ph
DIONES HOSPITAL ---> 17 Panay Avenue, Quezon City ---> ph
DIOSDADO P. MACAPAGAL ---> FOUNDATION, INC. ---> ph
DIPOLOG MEDICAL CENTER, INC. ---> Gusa Highway, ---> ph
DIVINE CARE HOSPITAL ---> Cagayan De Oro City ---> ph
DIVINE GRACE MEDICAL CENTER ---> Fuentes Drive, Roxas City ---> ph
DIVINE LOVE GENERAL HOSPITAL ---> Roxas Avenue, Roxas City ---> ph
DIVINE MERCY FOUNDATION OF ---> MEMORIAL HOSPITAL ---> ph
DIVINE MERCY HOSPITAL ---> Duero, Bohol ---> ph
DIVINE MERCY HOSPITAL ---> Capul, Northern Samar ---> ph
DIVINE WORD HOSPITAL ---> CARE LYING IN CENTER ---> ph
DIVINE WORD HOSPITAL ---> J.C. Avenue, Libertad ---> ph
DIZON MEDICAL CLINIC & HOSPITAL ---> Butuan City ---> ph
DOLORES MEDICARE AND ---> Rizal St., Surigao del Norte ---> ph
DOLORES MUNICIPAL HOSPITAL ---> HOSPITAL ---> ph
DOMINGO CASANO HOSPITAL ---> Tawag, Caramoan, Camarines Sur ---> ph
DOMINICAN HOSPITAL, INC. ---> HOSPITAL ---> ph
DON CIRIACO S.TIROL SR. ---> Datag, Caramoran, Catanduanes ---> ph
DON EMILIO DEL VALLE ---> Wilson St., Greenhills, ---> ph
DON JOSE S. MONFORT MEDICAL ---> San Juan ---> ph
DON JUAN MAYUGA ---> Carigara, Northern Leyte ---> ph
DON LEOVIGILDO DIAPO SR. ---> CHILDREN'S CLINIC ---> ph
DON MANUEL LOPEZ MEMORIAL ---> Cantilan, Surigao Del Sur ---> ph
DON MARIANO C. VERZOSA ---> MATERNITY CLINIC ---> ph
DON MODESTO FORMILLEZA ---> Cardona, Rizal ---> ph
DON RAMON TUGBANG ---> Don Andres Soriano, Toledo City ---> ph
DON SALVADOR BENEDICTO ---> Carmen, Davao del Norte ---> ph
DON SANTIAGO A. NAHIAL SR. ---> HOSPITAL ---> ph
DON VALERIO PALMARES, SR. ---> Carmen, Davao del Norte ---> ph
DOÑA JOSEFA EDRALIN ---> Nat'l. Highway, Panabo City ---> ph
DOÑA MARIA D. TAN ---> Davao del Norte ---> ph
DONA MARTA MEMORIAL ---> COMMUNITY HOSPITAL ---> ph
DONSOL DISTRICT HOSPITAL ---> Carranglan, Nueva Ecija ---> ph
DR. A. P. ZANTUA GE. HOSPITAL ---> 16 Tandang Sora Ave. ---> ph
DR. ADOLFO O. FLORES ---> Novaliches, Quezon City ---> ph
DR. ALBERTO M. PASTOR ---> Brgy. Marikit, Casiguran, Aurora ---> ph
DR. AMADO DIAZ PROVINCIAL ---> HOSPITAL (former CASTRO ---> ph
DR. AMANDO D. COPE ---> MATERNITY HOSPITAL) ---> ph
DR. AMANDO L. GARCIA MEDICAL ---> Baliuag, Bulacan ---> ph
DR. ANTONIO RANADA ---> Cataingan, Masbate ---> ph
DR. APOLLO DUQUE MEMORIAL ---> Carmona, Cavite ---> ph
DR. ATANACIO T. DAYRIT, JR. ---> Catarman, Camiguin ---> ph
DR. B.G. DONASCO MEDICAL ---> Cateel, Davao Oriental ---> ph
DR. BERNARDO B. CORRAL ---> Catigbian, Bohol ---> ph
DR. BONIFACIA V. ALBANO ---> Catubig, Northern Samar ---> ph
DR. DAMIAN REYES . H. HOSPITAL ---> Cauayan City, Isabela ---> ph
DR. EMIGDIO C. CRUZ SR. ---> Prenza, Cauayan City, Isabela ---> ph
DR. ERLINDA B. ESTANISLAO ---> HOSPITAL ---> ph
DR. ERLINDA P. TOLENTINO ---> Cauayan City, Isabela ---> ph
DR. ERVIN B. LUNTAO FAMILY ---> Cauyan, Negros Occidental ---> ph
DR. ESTEBAN V. ANTE ---> Cavite Blvd., Dalahican, Cavite ---> ph
DR. ESTER GARCIA GENERAL ---> Maragondon, Cavite ---> ph
DR. FE DEL MUNDO MEDICAL ---> Cavite City ---> ph
DR. EUTIQUIO LL. ALANACIO JR. ---> Cawayan, Masbate ---> ph
DR. FERNANDO B. DURAN SR. ---> Natalio, Bacalso Avenue, ---> ph
DR. GLORIA D. LACSON ---> Cebu City ---> ph
DR. GREGORIO B. TAN ---> Osmeña Blvd., Cebu City ---> ph
DR. GUMERSINDO GARCIA SR. ---> Talamban, Cebu City ---> ph
DR. HENRY M. DE VILLA ---> & MATERNITY HOSPITAL ---> ph
DR. HERNAN SORONGON SR. HOSPITAL ---> B. Rodriguez, Cebu City ---> ph
DR. IGNACIO M. CORTEZ ---> National Road, Tuyan,Naga, Cebu 50 ---> ph
DR. ILDEFONSO ALCANTARA ---> F. Ramos, Cebu City ---> ph
DR. JANET TUMOLVA ---> San Fernando City, Pampanga ---> ph
DR. JESUS C. DELGADO ---> HOSPITAL INC. ---> ph
DR. JOSE FABELLA MEMORIAL HOSPITAL ---> Bansalan, Davao Del Sur ---> ph
DR. JOSE R. REYES MEMORIAL ---> DON PEDRO HOSPITAL ---> ph
DR. JOSE P. RIZAL MEMORIAL ---> Nasugbu, Batangas ---> ph
DR. JOSE RIZAL MEMORIAL HOSPITAL ---> HOSPITAL ---> ph
DR. JOSE N. RODRIGUEZ ---> Narvacan, Ilocos Sur ---> ph
DR. JOSE MA. V. BORROMEO ---> HOSPITAL ---> ph
DR. JOSE MA. TORRES MEMORIAL ---> San Vicente, Tarlac City ---> ph
DR. LIM'S CLINIC AND HOSPITAL ---> UNIVERSITY HOSPITAL ---> ph
DR. LORENZO B. PRINCIPE ---> Muñoz, Nueva Ecija ---> ph
DR. LUIS P. MALALUAN HOSPITAL ---> UNIVERSITY HOSPITAL ---> ph
DR. MANUEL R. REBUENO ---> Musuan, Maramag, Bukidnon ---> ph
DR. MANUEL VELOSO ---> Sta. Cruz, Davao del Sur ---> ph
DR. MARCELO M. CHAN ---> HOSPITAL, INC. ---> ph
DR. MARIO D. BEJASA ---> Aparri, Cagayan ---> ph
DR. MIGUEL V. ALEGRE ---> Pob. Dinas, Zamboanga del Sur ---> ph
DR. MIRANDO C. UNCIANO ---> Calapan City, Oriental Mindoro ---> ph
DR. MONTANO G. RAMOS HOSPITAL ---> AND MEDICAL CENTER ---> ph
DR. MONTANO G. RAMOS ---> 286 Blumentritt St. ---> ph
DR. NILO O. ROA MEMORIAL ---> Sta Cruz, Manila ---> ph
DR. NOEL DE LEON ---> Fuente, Osmeña Street,Cebu ---> ph
DRA. OLIVIA SALAMANCA ---> Pagsanjan, Laguna ---> ph
DR. PABLO O. TORRE SR. ---> GENERAL HOSPITAL ---> ph
DR. PAULINO J. GARCIA MEMORIAL ---> 130 Real St., Pamplona ---> ph
DR. PETRONILO V. SEARES ---> Las Piñas City ---> ph
DR. RAFAEL S. TUMBOKON ---> Lingsat, San Fernando City ---> ph
DR. RAMON B. LEGASPI SR. ---> La Union ---> ph
DR. RICARDO S. PROVIDO SR. ---> Nat'l. Hi-way, San Nicolas ---> ph
DR. RICARDO Y. LADRIDO ---> Candon City, Ilocos Sur ---> ph
DR. ROBOSA HOSPITAL ---> Nunez Ext., Zamboanga City ---> ph
DR. ROLAND P. DELA ---> Clarin, Bohol ---> ph
DR. ROMEO ISANA ROSALES ---> Clark Field, Pampanga ---> ph
DR. SABILI GENERAL HOSPITAL ---> Anunas, Angeles City, Pampanga ---> ph
DR. SERAPIO M. MONTANER JR. ---> Claveria, Masbate ---> ph
DR. SOFRONIO B. GARCIA ---> GENERAL HOSPITAL ---> ph
DR. TOMAS L. NOLASCO SR. ---> 1430 D. Jose, Sta. Cruz, Manila ---> ph
DR. UY HOSPITAL, INC. ---> Bonifacio Street,Tuguegarao City ---> ph
DR. VICTOR POTENCIANO ---> Magsaygay Ave., Calinan ---> ph
DR. VICTOR S. VILLAROMAN ---> Davao City ---> ph
DR. YANGA'S HOSPITAL, INC. ---> Ormoc City ---> ph
DRA. ARACELI D. MENDOZA ---> Angeles City ---> ph
DRA. OLIVIA SALAMANCA ---> Calinan, Davao City ---> ph
DRAZEN MEDICAL HOSPITAL ---> Magallanes, Agusan Del Norte ---> ph
DUAY HOSPITAL ---> Norala, South Cotabato ---> ph
DUBONGCO'S MEDICAL CLINIC ---> Bonifacio, Misamis Occidental ---> ph
DUMANGAS DISTRICT HOSPITAL ---> Malalag, Davao del Sur ---> ph
DUAY HOSPITAL ---> Hagonoy, Davao del Sur ---> ph
DUBONGCO'S MEDICAL CLINIC ---> Malalag, Davao del Sur ---> ph
DUMANGAS DISTRICT HOSPITAL ---> Poblacion Esperanza ---> ph
DUMDUM MEDICAL CLINIC ---> Sultan Kudarat ---> ph
DUMLAO HOSPITAL ---> MEMORIAL HOSPITAL ---> ph
DUPAX DISTRICT HOSPITAL ---> (DASOL MUNICIPAL HOSPITAL) ---> ph
DUQUE GENERAL HOSPITAL ---> Dasol, Pangasinan ---> ph
E.B. MERCADO MEDICAL CLINIC ---> DEVELOPMENT COOP. HOSPITAL ---> ph
E.D. LIM MATERNITY AND ---> Anda Riverside, City Proper ---> ph
E.L. JOSON MEMORIAL HOSPITAL ---> Davao City ---> ph
E & R HOSPITAL & PHARMACY ---> SAN PABLO CITY, INC. ---> ph
E.S. GARCIA HOSPITAL ---> Colago Avenue, San Pablo City ---> ph
E. ZARATE HOSPITAL ---> OF BALAGTAS, CO. ---> ph
EAST AVENUE MEDICAL ---> Burol 1st, Balagtas, Bulacan ---> ph
EASTERN BICOL ---> Compostela, Compostela Valley ---> ph
EASTERN PANGASINAN ---> PROVINCIAL HOSPITAL ---> ph
EASTERN SAMAR PROVINCIAL ---> Montevista, Compostela Valley ---> ph
EASTERN VISAYAS REGIONAL ---> Brgy. Alfonso, Concepcion ---> ph
ECHAGUE DISTRICT HOSPITAL ---> Tarlac ---> ph
ED AND TITA CRUZ MATERNITY ---> MEMORIAL HOSPITAL ---> ph
EDIBORAH T. YAP MEMORIAL ---> Siaton, Negros Oriental ---> ph
EDWIN ANDREW'S AIRBASE ---> SR. MEMORIAL HOSPITAL ---> ph
ELEUTERIO T. DECENA ---> Loon, Bohol ---> ph
ELGUIRA GENERAL HOSPITAL ---> MEMORIAL HOSPITAL ---> ph
ELVIN U. MASIGAN INTEGRATED ---> Carmen, Bohol ---> ph
EMIL JOANNA GENERAL ---> Mabubua, Calafug ---> ph
EMILIO AGUINALDO COLLEGE ---> Conner, Apayao ---> ph
EMILIO G. PEREZ MEMORIAL ---> MEDICAL CENTER ---> ph
EMMANUEL HOSPITAL ---> Sogod, Southern Leyte ---> ph
ENGLEWOOD HOSPITAL ---> Rosario, Cavite ---> ph
ERMAVI HOSPITAL ---> AND HOSPITAL ---> ph
ERNESTO GUADALUPE MEDICAL ---> # 25 Tandang Sora St., Victory, ---> ph
ESCOLASTICA ROMERO ---> Norte, Santiago City, Isabela ---> ph
ESPERANZA MEDICARE ---> MEMORIAL REGIONAL HOSPITAL ---> ph
ESPINOZA-ROSARIO HOSPITAL ---> Lacson St., Bacolod City ---> ph
ESPIRITU MEDICAL CLINIC ---> Negros Occidental ---> ph
ESTACION MEDICAL CLINIC ---> Brgy. 5, Coron, Palawan ---> ph
ESTELA MEDICAL CLINIC ---> Sinait, Ilocos Sur ---> ph
ESTEVEZ MEMORIAL HOSP., INC. ---> Sogod, South Leyte ---> ph
ESTHER HOSPITAL ---> Cortes, Surigao del Sur ---> ph
ESTRELLA HOSPITAL ---> SPECIALIST HOSPITAL ---> ph
EUSER MEDICAL HOSPITAL ---> Quezon Avenue, CotabatoCity, ---> ph
EUSTAQUIO MEDICAL AND ---> Maguindanao ---> ph
EVANGELISTA MEDICAL CLINIC ---> Armas, Kidapawan ---> ph
EVANGELISTA MEDICAL AND ---> North Cotabato ---> ph
EVERSLEY CHILDS SANITARIUM ---> AND GENERAL HOSPITAL ---> ph
F. DAGOHOY MUNICIPAL HOSPITAL ---> Don Rufino Alonzo St. ---> ph
F.E.U. - NICANOR REYES MEDICAL ---> Cotabato City, Maguindanao ---> ph
F & P HERNANDEZ MATERNITY ---> AND MEDICAL CENTER ---> ph
F. Y. MANALO MEDICAL ---> Rosary Heights, Cotabato City ---> ph
FAIRVIEW GENERAL HOSPITAL ---> S.K. Maguindanao, ---> ph
FAITH HOSPITAL ---> Cotabato City ---> ph
FAMILY CARE HOSPITAL, INC. ---> Bacoor, Cavite ---> ph
FAMILY MEDICAL CLINIC ---> COMMUNITY HOSPITAL ---> ph
FANLO MEDICAL CLINIC ---> Quinipot, Zamboanga City ---> ph
FAR NORTH LUZON GEN. ---> HOSPITAL, INC. ---> ph
FATIMA UNIVERSITY MEDICAL ---> F. Salvador Ave., Jordan ---> ph
FEDERICO ROMAN TIRADOR SR. ---> Plains Subd. Brgy. Sta. Monica ---> ph
FELIPE ABRIGO MEMORIAL ---> Novaliches, Quezon City ---> ph
FERNANDO AIR BASE HOSPITAL ---> 37 Gen. Luna St., Tuktukan ---> ph
FIGUERRES CLINIC & HOSPITAL ---> Taguig City ---> ph
FIRST FILIPINO SAINT HOSPITAL ---> HOSPITAL AND PHARMACY ---> ph
FLORA DISTRICT HOSPITAL ---> Pikit, Northern Cotabato ---> ph
FLORDELIZ MEDICAL CLINIC ---> Navales St., Tandag ---> ph
FLORANTE V. BERNABE, SR. ---> Surigao del Sur ---> ph
FORT BONIFACIO GENERAL HOSPITAL ---> (formerly Cuison Family ---> ph
FORT DEL PILAR STATION HOSPITAL ---> Clinic Hospital) ---> ph
FORT MAGSAYSAY ARMY ---> Dagupan City ---> ph
FR. GERRY FILIPPETTO MEMORIAL ---> Culasi, Antique ---> ph
FR. TULIO FAVALI MUNICIPAL ---> Culion, Palawan ---> ph
FRANCISCO GENERAL HOSPITAL ---> Cuyo, Catadman, Palawan City ---> ph
FRANCO MEDICAL CLINIC ---> DBB, Dasmariñas Cavite ---> ph
G. GONZALES MEDICAL CLINIC ---> Poblacion, Macabebe, Pampanga ---> ph
G.M.A. MEDICARE HOSPITAL ---> Patin-ay, Agusan del Sur ---> ph
GABALDON MEDICARE ---> 484 Quirino Ave., Tambo ---> ph
GABRIELA SILANG GENERAL ---> Street, Parañaque City ---> ph
GALINATO FAMILY CLINIC & HOSPITAL ---> Daanbantayan, Cebu ---> ph
GAMAY DISTRICT HOSPITAL ---> MEMORIAL HOSPITAL ---> ph
GAMBALAN HOSPITAL ---> Dagupan City ---> ph
GAMEZ HOSPITAL ---> Tapuac District, Dagupan City ---> ph
GANDARA DISTRICT HOSPITAL ---> Danao, Cebu ---> ph
GAOAT GENERAL HOSPITAL ---> National Rd. Danao City ---> ph
GAPAN DISTRICT HOSPITAL ---> Sta. Clara, Naga ---> ph
GARCHITORENA MEDICARE ---> Zamboanga Sibucay ---> ph
GARCIA GENERAL HOSPITAL ---> CENTER (formerly Mercado Gen. Hosp.) ---> ph
GARCIA MEMORIAL PROVINCIAL ---> Tanauan, Batangas ---> ph
GAT ANDRES BONIFACIO ---> HOSPITAL ---> ph
GATA GENERAL HOSPITAL ---> UPI, Maguindanao ---> ph
GATTARAN EMERGENCY HOSPITAL ---> MEMORIAL HOSPITAL ---> ph
GEMARINO HOSPITAL ---> Bongao, Tawi-Tawi ---> ph
GEN. EMILIO AGUINALDO ---> Km. 7, McArthur Hi-way ---> ph
GEN. J. CAILLES MEMORIAL HOSPITAL ---> Bangkal, Davao City ---> ph
GEN. MAC ARTHUR MUNICIPAL ---> HOSPITAL ---> ph
GEN. MIGUEL MALVAR MEDICAL ---> Digos, Davao del Sur ---> ph
GEN. SANTOS CITY HOSPITAL ---> Quirino Avenue, Davao City ---> ph
GEN. TINIO MEDICARE AND ---> FOUNDATION - HOSPITAL ---> ph
GEN. TRIAS MATERNITY AND ---> Bajada, Davao City ---> ph
GEN. TRIAS MEDICARE ---> Toril, Davao City ---> ph
GEORGE DEWEY MEDICAL AND ---> HOSPITAL ---> ph
GERONA HOSPITAL OF THE ---> Mati, Davao Oriental ---> ph
GERTES CLINIC AND HOSPITAL ---> Apokon, Tagum City ---> ph
GIGAQUIT MUNICIPAL HOSPITAL ---> Davao del Norte ---> ph
GIGMOTO DISTRICT HOSPITAL ---> Roxas, Isabela ---> ph
GIG. OCA ROBLES SEAMEN'S HOSPITAL ---> FOUNDATION, INC. ---> ph
GILBERTO O. TEODORO ---> Milagros, Masbate ---> ph
GINES HOSPITAL ---> 5B. Aquino Ave. Baliuag, Bulacan ---> ph
GINGOOG SANITARIUM AND ---> 2921 Nagtahan Street ---> ph
GLAN MEDICARE COMMUNITY ---> Sta. Mesa, Manila ---> ph
GLORIA MEDICARE ---> Santiago City, Isabela ---> ph
GOLDEN ACRES DOCTOR'S ---> (formerly DECENA MEDICAL CLINIC) ---> ph
GOLDEN GATE GENERAL ---> Bonuan, Dagupan City, ---> ph
GOLINGAY GENERAL HOSPITAL ---> Pangasinan ---> ph
GONZAGA COMMUNITY CLINIC ---> MEDICAL CENTER - ANGELES BRANCH ---> ph
GONZALES GENERAL HOSPITAL ---> Henson St., Brgy. ---> ph
GONZALES MARANAN CLINIC ---> Agapito del Rosario, Angeles City ---> ph
GONZALES MEDICAL AND ---> Sibonga, Cebu ---> ph
GOOD NEWS CLINIC ---> Del Carmen, Surigao del Norte ---> ph
GOV. CELESTINO GALLARES ---> Calauag, Quezon ---> ph
GOV. FAUSTINO N. DY SR. ---> AND HOSPITAL ---> ph
GOV. GENEROSO MUNICIPAL ---> Carmen, Rosales, Pangasinan ---> ph
GOV. ROQUE B. ABLAN SR. ---> Bugo, Cagayan de Oro City ---> ph
GOV. WILLIAM "BILLY" VILLEGAS ---> Buhangin, Davao City ---> ph
GOV. VALERIANO GATUSLAO ---> #910 Crescini St., Caridad ---> ph
GOZO COMMUNITY HOSPITAL ---> Cavite City ---> ph
GRACE CHRISTIAN CLINIC ---> MEDICAL CENTER ---> ph
GRACE MEMORIAL HOSPITAL ---> Bagong Bayan, Dasmarinas ---> ph
GRACE MISSION HOSPITAL ---> Cavite ---> ph
GREAT SAVIOUR INTERNATIONAL ---> RODOLFO POBLETE MEM. HOSP. ---> ph
GREG HOSPITAL - SARIAYA, INC ---> Burgos St., Alfonso, Cavite ---> ph
GREGORIO DEL PILAR ---> Pob. Kapatagan, Lanao del Norte ---> ph
GREGORIO T. LLUCH MEMORIAL ---> Delfin Albano, Isabela, ---> ph
GREGORIO MATAS DISTRICT ---> Cagayan Valley ---> ph
GUBA COMMUNITY HOSPITAL ---> 201 E. Rodriguez Sr., Blvd. ---> ph
GUBAT DISTRICT HOSPITAL ---> Quezon City ---> ph
GUBATAN CLINIC ---> Pinamalayan, Oriental Mindoro ---> ph
GUIMARAS PROVINCIAL ---> PEDIATRIC CLINIC ---> ph
GUIMBA DISTRICT HOSPITAL ---> Ramon, Isabela ---> ph
GUIMBA GENERAL HOSPITAL ---> HOSPITAL ---> ph
GUINAYANGAN MEDICARE ---> Daclan, Bokod, Benguet ---> ph
GUMACA DISTRICT HOSPITAL ---> Malay-balay City, Bukidnon ---> ph
HCGC MEDICAL PLAZA ---> Diffun, Quirino ---> ph
H.M. CORACHEA GENERAL ---> HOSPITAL INC. ---> ph
H. VILL HOSPITAL ---> Langcangan, Oroquieta City ---> ph
H.W. MILLER MEMORIAL ---> Misamis Occidental ---> ph
HEALTH SERVICES LOS BANOS ---> Digos, Davao del Sur ---> ph
HEART OF JESUS HOSPITAL ---> (formerly Divine Heart Medical Services Dev't Coop.) ---> ph
HERAMIL'S MATERNITY AND ---> 215 Gen. Luis St., Novaliches ---> ph
HILONGOS DISTRICT HOSPITAL ---> Quezon City ---> ph
HINATUAN DISTRICT HOSPITAL ---> Nat'l. Hi-way, Pob., Dimiao, Bohol ---> ph
HINIGARAN MEDICAL CLINIC ---> Dinagat, Surigao del Norte ---> ph
HINUNANGAN COMMUNITY HOSPITAL ---> Dalican, Maguindanao ---> ph
HOFILEÑA HOSPITAL ---> Bo. Suyo, Dingras, Ilocos Norte ---> ph
HOLY CHILD OF BUTUAN HOSPITAL , INC. ---> Sulop, Davao del Sur ---> ph
HOLY CHILD HOSPITAL ---> MEMORIAL HOSPITAL ---> ph
HOLY CHILD MATERNITY ---> (formerly Pampanga ---> ph
HOLY FAMILY HOSPITAL ---> Provincial Hospital) ---> ph
HOLY FAMILY MEDICAL CENTER ---> Sta. Rita-Guagua, Pampanga ---> ph
HOLY INFANT CLINIC ---> Dipolog City, Zamboanga ---> ph
HOLYLIFE HEALTHCARE CENTER ---> MULTI SERVICES CORP ---> ph
HOLY NAZARENE CLINIC ---> Nar'l. Hi-way Sico II, San Juan ---> ph
HOLY ROSARY HOSPITAL ---> Batangas ---> ph
HOLY SPIRIT OF MINTAL CLINIC ---> (formerly DIVINE GRACE HOSPITAL ---> ph
HOLY TRINITY HOSPITAL ---> AND MATERNITY CENTER) ---> ph
HOLY TRINITY MEDICAL CLINIC ---> Rosario, Cavite ---> ph
HOLY TRINITY PLAZANG LUMA ---> Bypass Rd., Bacao, Tejero ---> ph
HOMONHON ISLAND ---> Gen. Trias, Cavite ---> ph
HOSPITAL DE SAN JUAN BAUTISTA ---> Lipa City, Batangas ---> ph
HOSPITAL OF THE HOLY CROSS ---> URDANETA HOSPITAL ---> ph
HOSPITAL OF THE INFANT JESUS ---> Urdaneta City, Pangasinan ---> ph
HOWARD HUBBARD ---> Mac Arthur Hi-way ---> ph
HUNGDUAN MUNICIPAL HOSPITAL ---> Anupul, Bamban, Tarlac ---> ph
IBAJAY DISTRICT HOSPITAL ---> San Pedro, Laguna ---> ph
IFUGAO GENERAL HOSPITAL ---> Hagonoy, Bulacan ---> ph
IGNACIO L. ARROYO SR., ---> Avenida Veteranos ---> ph
ILIGAN MEDICAL CENTER HOSPITAL ---> Tacloban City ---> ph
ILOCOS MED. AND HEALTH ---> J. P. Laurel St., Kidapawan City ---> ph
ILOCOS SUR COOPERATIVE ---> COMMUNITY HOSPITAL ---> ph
ILOCOS TRAINING AND ---> Dolores, Abra ---> ph
ILOILO DOCTOR'S ---> Dolores, Eastern Samar ---> ph
ILOILO MISSION HOSPITAL ---> Dolores, Eastern Samar ---> ph
ILOILO PROVINCIAL HOSPITAL ---> Quezon Avenue, Digos City ---> ph
IMMACULATE CONCEPCION ---> Davao del Sur ---> ph
IMMACULATE CONCEPCION ---> MEMORIAL HOSPITAL ---> ph
IMMACULATE CONCEPCION ---> Boracay Island, Malay, Aklan ---> ph
IMMACULATE CONCEPCION ---> MEMORIAL HOSPITAL ---> ph
IMMACULATE CONCEPCION ---> Ubay, Bohol ---> ph
IMMACULATE HEART OF ---> CENTER EXT. HOSPITAL ---> ph
IMUS FAMILY HOSPITAL ---> Barotac, Nuevo Iloilo ---> ph
INAPOY COMMUNITY PRIMARY ---> MEMORIAL HOSPITAL ---> ph
INFANTE HOSPITAL ---> Lemery, Batangas ---> ph
INTERGRATED CITY HEALTH OFFICE ---> MUNICIPAL HOSPITAL ---> ph
IPIL DOCTORS HOSPITAL ---> Madalag, Aklan ---> ph
IROSIN DISTRICT HOSPITAL ---> DISTRICT HOSPITAL ---> ph
ISAAC & CATALINA MED. CENTER ---> Balayan, Batangas ---> ph
ISAAC T. ROBILLO MEMORIAL ---> MEMORIAL HOSPITAL ---> ph
ISABELA DOCTOR'S GEN. HOSP. ---> (former Lingayen District Hosp.) ---> ph
ISIDRO C. KINTANAR ---> V. Solis St., Lingayen, Pangasinan 20 ---> ph
ISIDRO M. OLAN SR. MEMORIAL ---> SR. MEMORIAL HOSPITAL ---> ph
ISIP GENERAL HOSPITAL ---> Punta, Looc, Romblon ---> ph
ISULAN DOCTORS SPECIALIST ---> MEDICAL CENTER ---> ph
ITBAYAT DISTRICT HOSPITAL ---> (formely Barotac Viejo ---> ph
ITOGON MUNICIPAL HOSPITAL ---> Medical Center Inc.) ---> ph
J. CABAHUG HOSPITAL ---> Zulueta Drive, Barotac Viejo, ---> ph
J. HAGONOY MEDICAL CLINIC ---> Iloilo ---> ph
J. P. SIOSON GENERAL HOSPITAL ---> MEMORIAL DISTRICT HOSPITAL ---> ph
J.R. BORJA MEMORIAL CITY HOSPITAL ---> La Carlota City, Negros Occ. ---> ph
JVF CLINIC & LYING-IN MEMORIAL HOSPITAL ---> MEMORIAL HOSPITAL ---> ph
JABONGA MUNICIPAL HOSPITAL ---> Dinas, Zamboanga Del Sur ---> ph
JACALAN HOSPITAL ---> MEMORIAL DISTRICT HOSPITAL ---> ph
JAIME B.BERCES MEMORIAL ---> Alfelor St., Passi City, Iloilo ---> ph
JAMELARIN HOSPITAL (formerly ---> MARCOS DISTRICT HOSPITAL ---> ph
JAMES L. GORDON MEMORIAL ---> Marcos, Ilocos Norte ---> ph
JANE COUNTY HOSPITAL ---> MEMORIAL HOSPITAL ---> ph
JANUARIA MARCIAL ---> Baybay Mantio, Tangub City ---> ph
JASAAN MUNICIPAL HOSPITAL ---> Misamis Occidental ---> ph
JAVILLONAR CLINIC AND HOSPITAL ---> DISTRICT HOSPITAL ---> ph
JAVONILLO HOSPITAL ---> Atimonan, Quezon ---> ph
JECSONS MEDICAL CENTER ---> Donsol, Sorsogon ---> ph
JESUS COLMENARES DISTRICT ---> Virac, Catanduanes ---> ph
JESUS IMMACULATE ---> MEMORIAL HOSPITAL ---> ph
JESUS NAZARENE GENERAL HOSPITAL ---> Villasis, Santiago City ---> ph
JESUS OF NAZARETH HOSPITAL ---> HOSPITAL ---> ph
JESUS THE GOOD SHEPHERD HOSPITAL ---> Salawagan, Quezon, Bukidnon ---> ph
JESUS THE SAVIOR HOSPITAL ---> FOUNDATION HOSPITAL ---> ph
JNRAL FAMILY GENERAL HOSPITAL ---> Midsayap, North Cotabato ---> ph
JOHN PAUL HOSPITAL ---> MEMORIAL HOSPITAL ---> ph
JONES MEDICARE COMMUNITY ---> Tabaco, Albay ---> ph
JOSE B. LINGAD MEMORIAL ---> CENTER ---> ph
JOSE C. PAYUMO, JR. ---> 648 Rizal St., Angeles City ---> ph
JOSE PANGANIBAN PRIMARY ---> LYING-IN AND HOSPITAL ---> ph
JOSE R. REYES MEMORIAL ---> Brgy. 7-A Hernadez Ave. ---> ph
JOSEFINA BELMONTE DURAN ---> Laoag City ---> ph
JOWELL GENERAL HOSPITAL ---> HOSPITAL ---> ph
JUAN S. ALANO MEMORIAL ---> Cabiao, Nueva Ecija ---> ph
JUAN M. ALBERTO MEMORIAL ---> MEDICAL HOSPITAL ---> ph
JUAN B. DOSADO MEMORIAL ---> Centro, Cabatuan, Isabela ---> ph
JUAN M. DUYAN DISTRICT HOSPITAL ---> CLINIC & HOSPITAL ---> ph
JUDGE CELESTINO GUERERO ---> 27 Brgy. Paciano, Rizal, ---> ph
JULIO CARDINAL ROSALES ---> Calamba City, Laguna ---> ph
JUSTICE CALIXTO O. ZALDIVAR ---> MEMORIAL HOSPITAL ---> ph
JUSTICE JOSE ABAD SANTOS ---> (former St. Claire Medical Clinic) ---> ph
KC CALDERON HOSPITAL ---> Tiwi, Tabaco City ---> ph
KABACAN MEDICAL ---> MEMORIAL HOSPITAL ---> ph
KABACAN POLYMEDIC ---> Bacarra, Ilocos Norte ---> ph
KABANKALAN CITY HOSPITAL ---> (formerly Marinduque ---> ph
KABASALAN FATHFINDER HOSPITAL ---> Provincial Hospital) ---> ph
KABASALAN GENERAL HOSPITAL ---> Boac, Marinduque ---> ph
KAIROS MATERNITY AND ---> MEMORIAL HOSPITAL ---> ph
KALAMANSAG MUNICIPAL STATION ---> San Agustin, Arayat, Pampanga ---> ph
KALINGA DISTRICT HOSPITAL ---> MEMORIAL HOSPITAL ---> ph
KALINGA PROVINCIAL HOSPITAL ---> Pio Duran, Albay ---> ph
KALUMBOYAN COMMUNITY ---> MEDICAL CLINIC & HOSPITAL ---> ph
KANANGA COMMUNITY HOSPITAL ---> Unisan, Quezon ---> ph
KAPALONG DISTRICT HOSPITAL ---> CLINIC AND HOSPITAL ---> ph
KAPANGAN MEDICARE ---> National Hi-way, Pob. Sto Nino ---> ph
KAPATAGAN DISTRICT ---> South Cotabato ---> ph
KASIBU MUNICIPAL HOSPITAL ---> MEMORIAL HOSPITAL ---> ph
KAUSWAGAN PROVINCIAL HOSPITAL ---> Rizal St., Legazpi City ---> ph
KAWIT KALAYAAN HOSPITAL ---> HOSPITAL ---> ph
KAWIT MATERNITY & GENERAL ---> San Fermin, Cauayan City, ---> ph
KIAMBA DISTRICT HOSPITAL ---> Isabela ---> ph
KIDAPAWAN DOCTORS HOSP., INC. ---> CENTER FOUNDATION PHILS. ---> ph
KIDAPAWAN CITY HOSPITAL ---> 11 Banaue Street, Quezon City ---> ph
KIDAPAWAN MEDICAL ---> MEMORIAL HOSPITAL ---> ph
KISOLON EMERGENCY HOSPITAL ---> (formerly Sta. Rita Hospital) ---> ph
KITCHARAO DISTRICT HOSPITAL ---> MEMORIAL HOSPITAL ---> ph
KOLAMBUGAN PROVINCIAL HOSPITAL ---> Macabog, Sorsogon ---> ph
KUTA MAJ. SANG-AN STATION HOSPITAL ---> GEN. HOSPITAL ---> ph
L.G. CUTAMORA COMMUNITY HOSPITAL ---> San Leonardo, Nueva Ecija ---> ph
LA PAZ DISTRICT HOSPITAL ---> MEMORIAL HOSPITAL ---> ph
LA PAZ MEDICARE AND ---> Laoang, Northern Samar ---> ph
LA PAZ MUNICIPAL HOSPITAL ---> MEMORIAL HOSPITAL ---> ph
LA UNION MEDICAL DIAGNOSTIC ---> Kabankalan City, Negros Occ. ---> ph
LA UNION MEDICAL CENTER ---> MEMORIAL HOSPITAL ---> ph
LA VINA GENERAL HOSPITAL, INC. ---> (former St. Joseph Clinic) ---> ph
LAAK MUNICIPAL HOSPITAL ---> Ipil, Zamboanga Sibugay ---> ph
LABASON DIST. HOSPITAL ---> M'lang, North Cotabato ---> ph
LABO DISTRICT HOSPITAL ---> GENERAL HOSPITAL ---> ph
LABRADOR MUNICIPAL HOSPITAL ---> Mandaue City, Cebu ---> ph
LABUAN PUBLIC HOSPITAL ---> MEMORIAL HOSPITAL ---> ph
LADY OF LOURDES HOSPITAL ---> Dalaguete, Cebu ---> ph
LAGUNA DOCTORS HOSPITAL ---> LUSUNG MEDICAL CLINIC ---> ph
LAGUNA HOLY FAMILY HOSPITAL ---> AND LYING-IN ---> ph
LAGUNA PROVINCIAL HOSPITAL ---> Delfin Albano, Isabela ---> ph
LAHOZ CLINIC AND HOSPITAL ---> MEMORIAL HOSPITAL ---> ph
LAKE SEBU MUNICIPAL HOSPITAL ---> 7 Kamuning Road, ---> ph
LAMBAYONG DISTRICT HOSPITAL ---> Qeuzon City ---> ph
LANAO DEL NORTE ---> Lope de Vega St., ---> ph
LANCETA MEDICAL HOSPITAL ---> Sta. Cruz, Manila ---> ph
LANDERO CLINIC AND HOSPITAL ---> MEDICAL CENTER ---> ph
LANGUYAN MUNICIPAL HOSPITAL ---> Rizal Avenue, Sta. Cruz, Manila ---> ph
LAOAG CITY GENERAL HOSPITAL ---> DISTRICT HOSPITAL ---> ph
LAOAG PEDIATRIC HOSPITAL ---> Bucal, Calamba, Laguna ---> ph
LAPU-LAPU CITY HOSPITAL ---> Dapitan City, ---> ph
LARIOSA CLINIC & HOSPITAL ---> Zamboanga del Norte ---> ph
LAS NIEVES MUNICIPAL HOSPITAL ---> MEMORIAL HOSPITAL ---> ph
LAS PIÑAS CITY MEDICAL CENTER ---> Tala, Caloocan City ---> ph
LAS PIÑAS DOCTORS HOSP INC. ---> MEMORIAL HOSPITAL ---> ph
LASAM DISTRICT HOSPITAL ---> Pandacan, Pinamungahan, Cebu ---> ph
LAUREL MEMORIAL DISTRICT ---> FOUNDATION HOSP., INC. ---> ph
LAUREL MUNICIPAL HOSPITAL ---> Lamitan, Basilan ---> ph
LAZI MEDICARE ---> Valencia, Bohol ---> ph
LEBAK MEDICARE ---> CLINIC AND DRUGSTORE ---> ph
LEBAK DOCTOR'S HOSPITAL ---> Calinan, Davao del Sur ---> ph
LEBAK FAMILY DOCTORS HOSPITAL ---> Poblacion, Kidapawan ---> ph
LEMERY DOCTORS' MEDICAL CENTER ---> North Cotabato ---> ph
LEON D. HERNANDEZ ---> MEMORIAL HOSPITAL ---> ph
LEPANTO CONSOLIDATED ---> Oas, Albay ---> ph
Valencia, Bohol ---> MEMORIAL HOSPITAL ---> ph
LEONCIO GENERAL HOSPITAL ---> Palompon, Leyte ---> ph
LEONCIO UY MEMORIAL ---> MEMORIAL HOSPITAL ---> ph
LEYTE BAPTIST HOSPITAL, INC. ---> Carmen,Rosales, Pangasinan ---> ph
LEYTE PROVINCIAL HOSPITAL ---> GENERAL HOSPITAL ---> ph
LIANGA DISTRICT HOSPITAL ---> Bauan, Batangas ---> ph
LIANKO'S MEDICAL CLINIC ---> HOSPITAL ---> ph
LIAO'S CLINIC AND HOSPITAL ---> Labo, Camarines Norte ---> ph
LIBMANAN DISTRICT HOSPITAL ---> SR. MEDICAL CENTER ---> ph
LIDE PASAR HOSPITAL ---> V. Mapa St., Sta. Mesa Manila ---> ph
LILOAN COMMUNITY HOSPITAL ---> 46 Bukidnon St., Bago Bantay ---> ph
LILOY INTEGRATED HEALTH ---> Quezon City ---> ph
LIM COMMUNITY HOSPITAL ---> HOSPITAL ---> ph
LINGIG COMMUNITY HOSPITAL ---> Mindanao Avenue ---> ph
LIPA CITY DISTRICT HOSPITAL ---> Bahay Toro, Quezon City ---> ph
LIPA DOCTOR'S HOSPITAL ---> FOUNDATION HOSPITAL ---> ph
LIPA MEDIX MEDICAL CENTER ---> Naga City ---> ph
LIPUNAN HOSPITAL, INC. ---> MATERNITY CLINIC ---> ph
LITTLE ANGELS MEDICAL ---> Vira, Roxas, Isabela ---> ph
LIWAG MEDICAL CLINIC, INC. ---> MEMORIAL DISTRICT HOSPITAL ---> ph
LLANOS MEDICAL CLINIC ---> Gomez St., Cavite ---> ph
LLORENTE MUNICIPAL HOSPITAL ---> MEMORIAL HOSPITAL ---> ph
LOBO MUNICIPAL HOSPITAL ---> Sen. B. Aquino Drive ---> ph
LOPEZ DISTRICT FARMER'S HOSPITAL ---> Bacolod City, Negros Occidental ---> ph
LOPEZ FAMILY CLINIC AND HOSPITAL ---> RESEARCH & MEDICAL CENTER ---> ph
LOPEZ ST. JUDE GENERAL ---> Mabini St., Cabanatuan City, ---> ph
LORETO DISTRICT HOSPITAL ---> Nueva Ecija ---> ph
LORETO MUNICIPAL HOSPITAL ---> SR. , MEMORIAL HOSPITAL ---> ph
LORMA MEDICAL CENTER ---> Penarubia St., Bangued, Abra ---> ph
LORENZO D. ZAYCO DISTRICT HOSPITAL ---> MEMORIAL PROVINCIAL ---> ph
LOS BAÑOS DOCTORS HOSPITAL ---> HOSPITAL ---> ph
LOURDES HOSPITAL ---> Kalibo, Aklan ---> ph
LT. TIDANG MEMORIAL HOSPITAL ---> MEMORIAL HOSPITAL ---> ph
LU CLINIC AND HOSPITAL ---> Makato, Aklan ---> ph
LUBANG DISTRICT HOSPITAL ---> MEMORIAL DISTRICT HOSPITAL ---> ph
LUCAS-PAGUILA MEDICAL CLINIC ---> Calinog, Iloilo City ---> ph
LUCBAN MMG HOSPITAL ---> MEMORIAL HOSPITAL ---> ph
LUCENA MMG GENERAL HOSPITAL ---> Ladrido St., Lambunao, Iloilo ---> ph
LUCENA UNITED DOCTORS HOSPITAL ---> Baao, Camarines Sur ---> ph
LUDOVICE GENERAL HOSPITAL ---> CRUZ MEMORIAL HOSPITAL ---> ph
LUIS HORA MEMORIAL & ---> National Hi-way, Midsayap ---> ph
LUIS VILLA MEMORIAL HOSPITAL ---> North Cotabato ---> ph
LUISIANA DISTRICT HOSPITAL ---> GENERAL HOSPITAL ---> ph
LUMBIS - RANCES GEN. HOSP. ---> Brgy. Road Pob., P. Garcia ---> ph
LUNA GOCO MEDICAL CLINIC ---> Batangas ---> ph
LUNG CENTER OF THE PHILS. ---> AND HEALTH SERVICES ---> ph
LUPON DISTRICT HOSPITAL ---> 313 Gen. Santos Ave. ---> ph
LUTHERAN MEDICAL MISSION ---> L. Bicutan, Taguig ---> ph
LUUK DISTRICT HOSPITAL ---> AL-HAJ PROVINCIAL HOSPITAL ---> ph
LUZ-SIKATUNA COMMUNITY ---> Malabang, Lanao del Sur ---> ph
LUZON MEDICAL CENTER ---> MEMORIAL HOSPITAL ---> ph
LYCEUM OF APARRI HOSPITAL ---> Ligao City, Albay ---> ph
M.V. GALLEGO CABANATUAN ---> MEMORIAL HOSPITAL ---> ph
M. NAPEÑAS MEDICAL CLINIC ---> Centro Gatarao, Gattaran ---> ph
M.V. SANTIAGO MEDICAL CENTER ---> Cagayan Valley ---> ph
M. SIMON MEDICAL CLINIC ---> 19 Roxas Ave., Iligan City ---> ph
MCU-FDT MEDICAL ---> Lanao del Norte ---> ph
MMG HOSPITAL AND HEALTH ---> MEDICAL CENTER ---> ph
MMG HOSPITAL AND HEALTH ---> 163 Edsa, Mandaluyong City ---> ph
MPI-MEDICAL CENTER MUNTINLUPA ---> MEMORIAL HOSPITAL ---> ph
MA. ESTRELLA GENERAL HOSPITAL ---> Burgos St., Ilagan, Isabela ---> ph
MA. LOURDES MATERNITY HOSPITAL ---> Poblacion, Bocaue, Bulacan ---> ph
MAASIM MUNICIPAL HOSPITAL ---> MEMORIAL MEDICAL CLINIC ---> ph
MABALACAT DISTRICT HOSPITAL ---> (formerly Holy Family Medical Clinic) ---> ph
MABINAY MEDICARE ---> 24 Int. C.M Recto Ave. ---> ph
MACABEBE DISTRICT HOSPITAL ---> Lipa City ---> ph
MACTAN DOCTOR'S HOSPITAL ---> MEMORIAL DISTRICT HOSPITAL ---> ph
MADDELA MUNICIPAL HOSPITAL ---> P. Gomez St., Cavite City ---> ph
MADONNA AND CHILD HOSPITAL ---> Sinacaban, Misamis Occidental ---> ph
MADONNA GENERAL HOSPITAL ---> Brgy. Tolosa, Cabadbaran ---> ph
MADONNA GENERAL ---> Agusan del Norte ---> ph
MADRID DISTRICT HOSPITAL ---> Rosero St., Masbate City ---> ph
MAGALLANES MEDICARE ---> Dumangas, Iloilo ---> ph
MAGTABOG GENERAL HOSPITAL ---> Brgy. Tolosa, Cabadbaran ---> ph
MAGPOC MATERNITY ---> Agusan Del Norte ---> ph
MAGRINA CLINIC & HOSPITAL ---> Rosero St., Masbate City ---> ph
MAGSAYSAY MEMORIAL ---> Dumangas, Iloilo ---> ph
MAGSINGAL DISTRICT HOSPITAL ---> Balamban, Cebu ---> ph
MAGUINDANAO PROVINCIAL ---> Roxas, Isabela ---> ph
MAHAL NA VIRGEN MARIA ---> Dupax del Norte, Nueva Viscaya ---> ph
MAHAYAG DISTRICT HOSPITAL ---> San Juan, Batangas ---> ph
MAHESECO MULTI-PURPOSE ---> Kapatagan, Davao Del Sur ---> ph
MAINIT MEDICARE COMMUNITY ---> GENERAL HOSPITAL ---> ph
MAITUM MUNICIPAL HOSPITAL ---> Apalit, Pampanga ---> ph
MAJAYJAY MEDICARE HOSPITAL ---> Cabanatuan City ---> ph
MAJOR DANILO ATIENZA ---> Bo. C. Labao Ext., Iligan City ---> ph
MAKATI MEDICAL CENTER ---> 170 Malusak St., Sta Ana ---> ph
MAKILALA MEDICAL SPECIALIST ---> Bulacan, Bulacan ---> ph
MALASIQUI MUNICIPAL HOSPITAL ---> Talon, Las Piñas City ---> ph
MALATE MEDICAL CLINIC ---> CENTER ---> ph
MALAY MUNICIPAL HOSPITAL ---> East Avenue, Quezon City ---> ph
MALAYBALAY MEDICAL HOSPITAL ---> MEDICAL CENTER ---> ph
MALAYBALAY POLYMEDIC ---> Virac, Catanduanes ---> ph
MALIMONO DISTRICT HOSPITAL ---> DISTRICT HOSPITAL ---> ph
MALIPAYON DISTRICT HOSPITAL ---> Tayug, Pangasinan ---> ph
MALITA DISTRICT HOSPITAL ---> HOSPITAL ---> ph
MALOLOS MATERNITY ---> Borongan, Eastern Samar ---> ph
MALOLOS SAN ILDEFONSO ---> MEDICAL CENTER ---> ph
MALTA MEDICAL CENTER ---> R. Magsaysay Blvd. ---> ph
MALUNGON MUNICIPAL HOSPITAL ---> Tacloban City, Northern Leyte ---> ph
MAMBUSAO DISTRICT HOSPITAL ---> (PRIMO GAFFUD DIST. HOSP.) ---> ph
MANABAT MATERNITY AND ---> Ipil Echague, Isabela ---> ph
MANANGAN CLINIC AND HOSPITAL ---> AND SURGICAL HOSPITAL ---> ph
MANANGO HOSPITAL ---> Bagbaguin, Sta. Maria, Bulacan ---> ph
MANAOAG COMMUNITY HOSPITAL ---> HOSPITAL ---> ph
MANAY DISTRICT HOSPITAL ---> Lamitan, Basilan ---> ph
MANDALUYONG CITY ---> HOSPITAL ---> ph
MANDAON MEDICARE ---> Sta. Maria, Zamboanga City ---> ph
MANGATAREM DISTRICT HOSP. ---> MEMORIAL HOSPITAL ---> ph
MANILA ADVENTIST MEDICAL ---> Bacuyangan, Hinobaan, ---> ph
MANILA DOCTOR'S HOSPITAL ---> Negros Occidental ---> ph
MANILA EAST MEDICAL CENTER ---> Rizal Ave., San Carlos City ---> ph
MANILA NAVAL HOSPITAL ---> Pangasinan ---> ph
MANITO MUNICIPAL HOSPITAL ---> MEMORIAL HOSPITAL ---> ph
MANSALAY MEDICARE HOSPITAL ---> Sta. Maria, Isabela ---> ph
MANUEL HOSPITAL ---> HOSPITAL ---> ph
MANUEL A. ROXAS DISTRICT HOSPITAL ---> 147 Quezo St., Atimonan, Quezon ---> ph
MANUEL J. SANTOS HOSPITAL ---> MEDICAL CENTER - CAVITE ---> ph
MANUKAN MEDICARE ---> Brgy. Salitran II ---> ph
MAPANDAN MUNICIPAL HOSPITAL ---> Dasmarinas Cavite ---> ph
MAPANDI MEMORIAL HOSPITAL ---> HOSPITAL ---> ph
MARAAT MEDICAL HOSPITAL ---> Sto. Niño, Hagonoy, Bulacan ---> ph
MARAGUSAN MUNICIPAL ---> San Jose, San Miguel, Bulacan ---> ph
MARAMAG MEDICLINIC AND ---> Tagbilaran City ---> ph
MARANDING COMMUNITY HOSPITAL ---> Kibawe, Bukidnon ---> ph
MARCELLO HOSPITAL ---> CLINIC AND LABORATORY ---> ph
MARCELLO-PADILLA CHILDREN'S ---> Daliao, Toril, Davao City ---> ph
MARGOSA TUBIG REGIONAL ---> DISTRICT HOSPITAL ---> ph
MARIA L. ELEAZAR MEMORIAL ---> San Nicolas 1st., Lubao ---> ph
MARIA LOURDES MATERNITY ---> Pampanga ---> ph
MARIA REYNA HOSPITAL ---> COMMUNITY HOSPITAL ---> ph
MARIAN HOSPITAL OF STA. ROSA, INC. ---> Esperanza, Agusan del Sur ---> ph
MARIANO JESUS CUENCO ---> Malasiqui, Pangasinan ---> ph
MARIANO MARCOS MEMORIAL ---> AND HOSPITAL ---> ph
MARIHATAG DISTRICT HOSPITAL ---> Sto. Tomas, Davao Del Norte ---> ph
MARIKINA ST. VINCENT ---> AND HOSPITAL ---> ph
MARIKINA VALLEY MEDICAL CENTER ---> Malita, Davao del Sur ---> ph
MARKVIM HOSPITAL ---> AND PHARMACY ---> ph
MARIBOJOC COMMUNITY ---> Sto. Tomas, Davao del Norte ---> ph
MARSMAN ESTATE ---> Legaspi City ---> ph
MARTIN MARASIGAN MEMORIAL ---> Pob. Highway, Valencia City ---> ph
MARTINEZ MEMORIAL HOSPITAL ---> Bukidnon ---> ph
MARY CHILES GENERAL HOSPITAL ---> Aguin H-way, Silang, Cavite ---> ph
MARY IMMACULATE ---> Tambulig, Zamboanga del Sur ---> ph
MARY IMMACULATE HOSPITAL ---> OB-GYNE MEDICAL CLINIC ---> ph
MARY JOHNSTON HOSPITAL ---> Plazang Luma, Arayat, Pampanga ---> ph
MARY MEDIATRIX MEDICAL ---> AND HOSPITAL ---> ph
MARY THE QUEEN MATERNITYAND ---> Lambayong, Sultan Kudarat ---> ph
MASBATE DOCTORS HOSPITAL ---> SPECIALTY HOSPITAL ---> ph
MASBATE PROVINCIAL HOSPITAL ---> San Pedro, Laguna ---> ph
MASONGSONG CLINIC ---> Mandaue City ---> ph
MATAAS NA KAHOY COMMUNITY ---> Inabanga, Bohol ---> ph
MATEO'S DIAGNOSTIC CLINIC ---> FOUNDATION MEDICAL CENTER ---> ph
MATIAS CLINIC AND HOSPITAL ---> Regalado Ave., Fairview, ---> ph
MATILDE A. OLIVAS DISTRICT ---> Quezon City ---> ph
MATNOG MEDICARE ---> AND LYING-IN CLINIC ---> ph
MATUTES MEDICAL CLINIC ---> McArthur Highway, ---> ph
MAUBAN DISTRICT HOSPITAL ---> Valenzuela City ---> ph
MAWAB MEDICAL CLINIC AND ---> FOUNDATION, INC. ---> ph
MAYOR HILARION A. RAMIRO SR. ---> NEW ERA GEN. HOSPITAL ---> ph
MAYOR JOAQUIN G. MACIAS ---> Commonwealth Ave., cor ---> ph
MAYOYAO DISTRICT HOSPITAL ---> Tandang Sora, New Era ---> ph
MCPC ST. THERESE OF USIEUX ---> Quezon City ---> ph
MEDICAL CENTER OF DIGOS ---> L20 cor. Mercury Street ---> ph
MEDICAL CENTER IMUS ---> Quezon City ---> ph
MEDICAL CENTER MANILA ---> Ozamis City ---> ph
MEDICAL CENTER PARAÑAQUE, INC. ---> San Pedro, Laguna ---> ph
MEDICAL CENTRUM DAGUPAN ---> #4 Caramcam District, Mangagoy ---> ph
MEDICAL MISSION GROUP ---> Bislig City, Surigao del Sur ---> ph
MEDICAL MISSION GROUP ---> Malita, Davao del Sur ---> ph
MEDICAL MISSION GROUP ---> HOSP. & TRAINING CENTER ---> ph
MEDICAL MISSION GROUP HOSPITAL ---> Pob. Luna, Apayao ---> ph
MEDICAL MISSION GROUP HOSPITAL ---> CENTER, INC. ---> ph
MEDICARE COMMUNITY ---> 120 McArthur Highway ---> ph
MEDIDAS MEDICAL CLINIC ---> Valenzuela City ---> ph
MEDINA GENERAL HOSPITAL ---> MEMORIAL DISTRICT HOSPITAL ---> ph
MELVERY MATERNITY HOSPITAL ---> Janiuay, Iloilo ---> ph
MENDOZA GENERAL ---> HOSPITAL ---> ph
MERCEDES MEDICAL CENTER ---> Guiuan, Eastern Samar ---> ph
MERCY CLINIC AND HOSPITAL ---> Lipa City, Batangas ---> ph
MERCY COMMUNITY ---> Vigan, Ilocos Sur ---> ph
METRO LEMERY MED. CENTER ---> (SAN LORENZO RUIZ) ---> ph
METRO LIPA MEDICAL CENTER ---> Brgy. San Roque, Naic, Cavite ---> ph
METRO PAGADIAN HOSPITAL, INC. ---> Flora, Apayao ---> ph
METRO RIZAL DOCTORS HOSPITAL ---> Mawab, Campostela Valley ---> ph
METRO SOUTH MEDICAL CENTER ---> MEMORIAL HOSPITAL ---> ph
METRO VIGAN COOPERATIVE HOSPITAL ---> Quirino Ave., La Huerta ---> ph
METROPOLITAN MEDICAL ---> Paranaque City ---> ph
METROPOLITAN MEDICAL CENTER ---> Fort Andres Bonifacio ---> ph
MEYCAUAYAN DOCTORS ---> Makati City ---> ph
MIDSALIP INFIRMARY HOSPITAL ---> PMA, Fort Del Pilar ---> ph
MIDSAYAP COMMUNITY ---> Baguio City ---> ph
MIDSAYAP DIAGNOSTIC ---> STATION HOSPITAL ---> ph
MIGUEL CLINIC ---> 7th Infantry Division, Phil. Army ---> ph
MILAGROS DISTRICT HOSPITAL ---> Fort Ramon Magsaysay ---> ph
MINA DE ORO GENERAL ---> Palayan City, Nueva Ecija ---> ph
MINDANAO SPECIALIST HOSPITAL ---> FOUNDATION HOSPITAL ---> ph
MINDANAO CENTRAL SANITARIUM ---> Sta Cruz, Cagayan ---> ph
MINDANAO SANITARIUM AND HOSPITAL ---> HOSPITAL ---> ph
MINGLANILLA DISTRICT HOSPITAL ---> Tulunan, North Cotabato ---> ph
MIRACULOUS MEDAL EMERGENCY ---> Urdaneta City, Pangasinan ---> ph
MIRANDA FAMILY HOSPITAL ---> AND HOSPITAL ---> ph
MISAMIS COMMUNITY ---> Trento, Agusan Del Sur ---> ph
MISAMIS OCCIDENTAL ---> Tiwi, Albay ---> ph
MISAMIS ORIENTAL PROVINCIAL ---> G.M.A., Cavite ---> ph
MISAMIS ORIENTAL PROVINCIAL ---> COMMUNITY HOSPITAL ---> ph
MISAMIS ORIENTAL PROVINCIAL ---> Gabaldon, Nueva Ecija ---> ph
MISAMIS ORIENTAL PROVINCIAL ---> HOSPITAL ---> ph
MISAMIS ORIENTAL PROVINCIAL ---> Tamag, Vigan, Ilocos Sur ---> ph
MISAMIS ORIENTAL PROVINCIAL ---> Guyabano St., Kalawag II Isulan, ---> ph
MISAMIS ORIENTAL PROVINCIAL ---> Sultan Kudarat ---> ph
MISAMIS UNIVERSITY MEDICAL CENTER ---> Gamay, Northern Samar ---> ph
MISSION HOSPITAL ---> San Antonio Delfin, Albano, Isabela 8 ---> ph
M'LANG DISTRICT HOSPITAL ---> 218 J. P. Rizal St., Calamba ---> ph
M'LANG DOCTOR'S HOSPITAL, INC. ---> Laguna ---> ph
MOISES ESPINOSA SR. MEMORIAL ---> Gandara, Western Samar ---> ph
MOLINO DOCTORS HOSPITAL ---> Brgy. 11 Ben Agan, Batac ---> ph
MORONG DOCTORS HOSPITAL ---> Ilocos Norte ---> ph
MOTHER AND CHILD HOSPITAL ---> Bayanihan, Gapan, Nueva Ecija ---> ph
MOTHER OF MERCY HOSPITAL ---> COMMUNITY HOSPITAL ---> ph
MOTHER OF PERPETUAL HELP HOSPITAL ---> Garchitorena, Camarines Sur ---> ph
MOTHER TERESA OF CALCUTTA ---> 49 B. Bayanan Ave. ---> ph
MT. CARMEL DIOCESAN ---> Concepcion, Marikina City ---> ph
MT. CARMEL HOSPITAL MEDICAL ---> HOSPITAL ---> ph
MT. OF BLESSINGS HOSPITAL ---> Talibon, Bohol ---> ph
MUÑOZ CLINIC ---> MEMORIAL MEDICAL CENTER ---> ph
N. L. VILLA MEMORIAL MEDICAL ---> Delpan St., Tondo, Manila ---> ph
N. MED-CARE HOSPITAL ---> Guinobatan, Albay ---> ph
NABILOG COMMUNITY ---> Calaoagan, Dakkel, Cagayan ---> ph
NABUNTURAN DOCTORS HOSPITAL, ---> Diplahan, Zamboanga Sibugay ---> ph
NAGA CITY HOSPITAL ---> MEMORIAL HOSPITAL ---> ph
NAGCARLAN DISTRICT ---> Luciano, Trece Martires City, ---> ph
NAGUILIAN DISTRICT ---> Cavite ---> ph
NAIC DOCTORS HOSPITAL ---> Tavera, Pakil, Laguna ---> ph
NAIC MEDICARE HOSPITAL ---> HOSPITAL ---> ph
NAQUITQUITAN MEDICAL ---> Gen. MacArthur, Eastern Samar ---> ph
NARRA MUNICIPAL HOSPITAL ---> FOUNDATION HOSPITAL ---> ph
NASIPIT DISTRICT HOSPITAL ---> 531 Commonwealth, Quezon City ---> ph
NATIONAL CENTER FOR ---> Gen. Santos City, ---> ph
NATIONAL CHILDREN'S HOSPITAL ---> South Cotabato ---> ph
TRANSPLANT INSTITUTE ---> COMMUNITY HOSPITAL ---> ph
NATONIN COMMUNITY HOSPITAL ---> General Tinio, Nueva Ecija ---> ph
NAUJAN MUNICIPAL HOSPITAL ---> PEDIATRIC HOSPITAL ---> ph
NAZARENUS COLLEGE ---> Gen. Trias, Cavite ---> ph
NAZARETH GENERAL HOSPITAL, INC. ---> HOSPITAL ---> ph
NEGROS ORIENTAL PROVINCIAL HOSPITAL ---> Pinagtipunan, Gen. Trias, Cavite ---> ph
NEOPOLITAN MEDICAL MATERNITY ---> WELLNESS CENTER ---> ph
NEW BAYUGAN MEDICAL HOSPITAL ---> Olongapo City, Zambales ---> ph
NEW BILIBID PRISONS HOSPITAL ---> SACRED HEART ---> ph
NEW LUCENA POLYTECHNIC COLLEGE ---> Abagon, Gerona, Tarlac ---> ph
NEW SAMARITAN MEDICAL ---> Brgy# 15 San Nicolas, Ilocos Norte 10 ---> ph
NEW SINAI MDI HOSPITAL ---> Gigaquit, Surigao del Norte ---> ph
NODADO GENERAL HOSPITAL ---> Gigmoto, Catanduanes ---> ph
NODADO GENERAL HOSPITAL ---> R. Castillo St., Davao City ---> ph
NODADO GENERAL HOSPITAL ---> MEMORIAL HOSPITAL ---> ph
NORALA DISTRICT HOSPITAL ---> Brgy. Malacampa, Camiling, Tarlac 25 ---> ph
NORTH CALOOCAN ---> Roxas St, Cauayan, Isabela ---> ph
NORTHERN CAGAYAN ---> HOSPITAL, INC. ---> ph
NORTHERN DOCTORS ---> Bagaipo St., Gingoog City ---> ph
NORTHERN LA UNION MATERNITY ---> Misamis Oriental ---> ph
NORTHERN MINDANAO ---> HOSPITAL ---> ph
NORTHERN SAMAR PROVINCIAL ---> Glan, Sarangani ---> ph
NORTHWESTERN LEYTE ---> COMMUNITY HOSPITAL ---> ph
NORZAGARAY MUNICIPAL HOSPITAL ---> Gloria, Oriental Mindoro ---> ph
NOTRE DAME HOSPITAL AND ---> HOSPITAL ---> ph
NOTRE DAME OF DE CHARTERS ---> Talon V, Las Piñas City ---> ph
NOVALICHES DISTRICT HOSPITAL ---> HOSPITAL ---> ph
NOVALICHES GENERAL HOSPITAL ---> Batangas City ---> ph
NUESTRA SEÑORA DE PIAT ---> Malalag, Davao del Sur ---> ph
NUESTRO ESPIRITU MEDICALSURGICAL ---> Gonzaga, Cagayan ---> ph
NUEVA ECIJA DOCTOR'S HOSP. INC. ---> San Leonardo, Nueva Ecija ---> ph
NUEVA ECIJA GOOD SAMARITAN ---> AND HOSPITAL ---> ph
NUEVA ECIJA GOOD SAMARITAN ---> Digos City, Davao del Sur ---> ph
NUEVA VALENCIA DISTRICT HOSPITAL ---> CHILDRENS HOSPITAL ---> ph
NUEVA VISCAYA PROVINCIAL HOSPITAL ---> Tanauan City, Batangas ---> ph
OCAMPO MUNICIPAL HOSPITAL ---> Banawe, Ifugao ---> ph
OCCIDENTAL MINDORO ---> MEMORIAL HOSPITAL ---> ph
OFELIA MENDOZA MATERNITY ---> Tagbilaran City, Bohol ---> ph
OLIVAREZ GENERAL HOSPITAL ---> MEMORIAL HOSPITAL ---> ph
OLUTANGA MUNICIPAL HOSPITAL ---> Ilagan, Isabela ---> ph
ORANI DISTRICT HOSPITAL ---> HOSPITAL ---> ph
ORAS DISTRICT HOSPITAL ---> Gov. Generoso, Davao Oriental ---> ph
ORDOÑEZ ADULT AND ---> MEMORIAL HOSPITAL ---> ph
ORDOÑEZ MEDICAL HOSPITAL ---> P. Gomez, Laoag City ---> ph
ORIENTAL MINDORO ---> Ilocos Norte ---> ph
ORION ST. MICHAEL HOSPITAL ---> MEMORIAL HOSPITAL ---> ph
ORMOC DISTRICT HOSPITAL ---> Guihulngan, Negros Oriental ---> ph
ORMOC MATERNITY AND ---> MEMORIAL DIST. HOSP. ---> ph
OROQUIETA COMMUNITY ---> Himamaylan, Negros Occidental ---> ph
OSLOB DISTRICT HOSPITAL ---> Maranding, Lala, Lanao Del Norte ---> ph
OSPA FARMERS MEDICAL CENTER ---> AND HOSPITAL ---> ph
OSPITAL NING ANGELES ---> 03 Capitol Road, Surigao City ---> ph
OSPITAL NING CAPAS ---> Surigao del Norte ---> ph
OSPITAL NG BARAS ---> FOUNDATION, INC. ---> ph
OSPITAL NG BIÑAN ---> (formerly Grace Memorial Maternity ---> ph
OSPITAL NG CABUYAO ---> and General Hospital) ---> ph
OSPITAL NG GUIGUINTO ---> 003 Burol 2nd, Balagtas, Bulacan ---> ph
OSPITAL NG KABATAAN ---> Katiningan, Socorro ---> ph
OSPITAL NG LUNGSOD NG ---> Oriental Mindoro ---> ph
OSPITAL NG MAKATI ---> HOSPITAL, INC. ---> ph
OSPITAL NG MAKATI ---> Solis St., Tap-oc, Molo, Iloilo City ---> ph
OSPITAL NG MAYNILA ---> Gen Luna St., Sariaya, Quezon ---> ph
OSPITAL NG MUNTINLUPA ---> DISTRICT HOSPITAL ---> ph
OSPITAL NG PALAWAN ---> Bagumbayan, Balagtas, Bulacan ---> ph
OSPITAL NG SAMPALOC ---> HOSPITAL ---> ph
OSPITAL NG STA. CRUZ ---> Pala-o, Iligan City ---> ph
OSPITAL NG TAGAYTAY ---> HOSPITAL ---> ph
OSPITAL NG TONDO ---> Kibiawan, Davao del Sur ---> ph
OUR LADY OF CAYSASAY ---> Guba, Cebu ---> ph
OUR LADY OF FATIMA HOSPITAL ---> Gubat, Sorsogon ---> ph
OUR LADY OF FATIMA MEDICAL ---> Burol 2nd, Balagtas, Bulacan ---> ph
OUR LADY OF GRACE HOSPITAL ---> HOSPITAL (IPHO) ---> ph
OUR LADY OF GUADALUPE HOSPITAL ---> San Miguel Jordan, Guimaras ---> ph
OUR LADY OF HOPE MEDICAL ---> Pacac, Guimba, Nueva Ecija ---> ph
OUR LADY OF LOURDES HOSPITAL ---> Guimba, Nueva Ecija ---> ph
OUR LADY OF LOURDES ---> COMMUNITY HOSPITAL ---> ph
OUR LADY OF LOURDES ---> Guinayangan, Quezon ---> ph
OUR LADY OF MEDIATRIX HOSPITAL ---> Gumaca, Quezon ---> ph
OUR LADY OF MERCY ---> 260 San Jose St., Carmona ---> ph
OUR LADY OF MT. CARMEL ---> Cavite ---> ph
OUR LADY OF MT. CARMEL ---> HOSPITAL ---> ph
OUR LADY OF PEACE HOPSITAL ---> Tanauan City, Batangas ---> ph
OUR LADY OF PIAT POLYCLINIC ---> Manggahan, Rodriguez, Rizal ---> ph
OUR LADY OF PORCIUNCULA ---> SANITARIUM AND HOSPITAL ---> ph
OUR LADY OF PURIFICATION ---> 400 Tres de Abril St., Cebu City ---> ph
OUR LADY OF ROSARY ---> HOSPITAL AND MEDICAL CENTER ---> ph
OUR LADY OF RULE MATERNITY ---> Los Banos, Laguna ---> ph
OUR LADY OF THE PILLAR ---> San Jose City, Nueva Ecija ---> ph
OUR LADY OF THE WAY ---> CHILDREN'S HOSPITAL ---> ph
OUR SAVIOR HOSPITAL., INC. ---> Polomolok, South Cotabato ---> ph
OVERSEAS CONTRACT ---> Hilongos, Northern Leyte ---> ph
OZAMIS CITY ST. JOSEPH ---> Hinatuan, Surigao del Sur ---> ph
P. GONZALES MEMORIAL ---> Hinigaran, Negros Occidental ---> ph
PLT COLLEGE, INC - LUIS TIAM ---> Hinunangan, Southern Leyte ---> ph
PACENCIA GONZALES MEMORIAL ---> Pagadian City ---> ph
PACUAN COMMUNITY ---> 102 South Drive, Guingona Subd. ---> ph
PADRE BURGOS ---> Agusan del Norte ---> ph
PADRIGUILAN'S MATERNITY ---> Dumaguete City, Negros Oriental ---> ph
PADRON -TIBIO MEDICAL CLINIC ---> AND CHILDREN'S CLINIC ---> ph
PAETE GENERAL HOSPITAL ---> Ambrosio St., Urdaneta City ---> ph
PAGADIAN CITY MEDICAL HOSPITAL ---> Bongao, Tawi-Tawi ---> ph
PAGADIAN DOCTOR'S HOSPITAL ---> Sto. Cristo, Angeles City, ---> ph
PAGAMUTANG BAYAN NG CARMONA ---> Pampanga ---> ph
PAGAMUTANG BAYAN NG MALABON ---> Roxas Avenue, Tuguegarao City ---> ph
PAGAMUTANG BAYAN NG CARMONA ---> Pres. Quezon Ave. ---> ph
PAGAMUTANG PANGMASA NG LAGUNA ---> Lifehomes Subd. ---> ph
PAG-ASA HOSPITAL ---> Rosario, Pasig City ---> ph
PAGSANJAN MEDICAL CLINIC INC. ---> AND HOSPITAL ---> ph
PAHILAN FAMILY CLINIC ---> Valdez St., Kalawag II ---> ph
PALANAN STATION HOSPITAL ---> Isulan, Sultan Kudarat ---> ph
PALAWAN ADVENTIST HOSPITAL ---> San Isidro, Lopez, Quezon ---> ph
PALAWAN BAPTIST HOSPITAL ---> Sampaguita St., Mintal ---> ph
PALMA-MALALUAN HOSPITAL ---> Davao City ---> ph
PALUAN MEDICARE ---> (former Jose S. Domingo Hosp.) ---> ph
PAMANA MEDICAL CENTER ---> 505 Quezon St. ---> ph
PAMPANGA EENT AND ---> San Miguel, Tarlac City ---> ph
PAMPANGA MEDICAL SPECIALIST ---> Tabuk, Kalinga ---> ph
PAMPLONA MEDICAL CLINIC ---> MEDICAL CLINIC ---> ph
PANABO POLYMEDIC HOSPITAL ---> Plazang Luma, Arayat, Pampanga ---> ph
PANAYAMAN GENERAL HOSPLITAL ---> COMMUNITY HOSPITAL ---> ph
PANDAN DISTRICT HOSPITAL ---> Homonhon Island, Eastern Samar ---> ph
PANGASINAN CENTER FOR ---> Kap Isko Brgy II, Lian, Batangas ---> ph
PANGASINAN DOCTORS HOSPITAL ---> VR Medrano Calapan City ---> ph
PANGASINAN MEDICAL ---> Oriental Mindoro ---> ph
PANGUTARAN DISTRICT HOSPITAL ---> 1556 Laong Laan St. ---> ph
PANLALAWIGAN PAGAMUTAN ---> Sampaloc, Manila ---> ph
PANOPDOPAN DISTRICT HOSPITAL ---> MEMORIAL HOSPITAL ---> ph
PANOPIO MEDICAL AND ---> Polomolok, South Cotabato ---> ph
PANTALEON G. GOTLADERA ---> Hungduan, Ifugao ---> ph
PANTAO DISTRICT HOSPITAL ---> Ibajay, Aklan ---> ph
PANTINOPLE MEDICAL CLINIC ---> Lagawe, Ifugao ---> ph
PANTUKAN DISTRICT HOSPITAL ---> MEMORIAL DISTRICT HOSPITAL ---> ph
PARACELIS DISTRICT HOSPITAL ---> Burgos St., Isabela ---> ph
PARAÑAQUE DOCTOR'S HOSPITAL ---> Negros Occidental ---> ph
PARANG DISTRICT HOSPITAL ---> San Miguel Village, Pala-o ---> ph
PASAY CITY GENERAL HOSPITAL ---> Iligan City, Lanao Del Norte ---> ph
PASCUAL GENERAL HOSPITAL ---> SERVICES COOPERATIVE ---> ph
PASIG CITY GENERAL HOSPITAL ---> (ST. THERESE HOSP.) ---> ph
PASOLO MATERNITY AND ---> San Lorenzo, Ilocos Norte ---> ph
PATHFINDER ESTATE HOSPITAL ---> MEDICAL MISSION GROUP ---> ph
PAULINA LIM MEMORIAL HOSPITAL ---> AND HOSPITAL ---> ph
PAULINO HOSPITAL ---> Jose Singson, Vigan City ---> ph
PAYAO MUNICIPAL HOSPITAL ---> REGIONAL MEDICAL CENTER ---> ph
PAZZU MEDICAL CLINIC ---> San Fernando City, La Union ---> ph
PEDRO L. GINDAP MUNICIPAL ---> HOSPITAL INC. ---> ph
PERPETUAL HELP CLINIC ---> West Avenue, Molo, Iloilo ---> ph
PERPETUAL HELP HOSPITAL ---> Mission Road, Jaro, Iloilo ---> ph
PERPETUAL HELP HOSPITAL ---> Pototan, Iloilo ---> ph
PERPETUAL HELP HOSPITAL ---> CLINIC AND HOSPITAL ---> ph
PERPETUAL SUCCOR HOSPITAL ---> Guiuan, Eastern Samar ---> ph
PERPETUAL SUCCOUR HOSPITAL ---> HEALTH CENTER ---> ph
PETER PAUL MEDICAL CENTER ---> Victorias City, Negros Occidental ---> ph
PHILIPPINE CHILDREN'S ---> HOSPITAL, INC. ---> ph
PHILIPPINE GENERAL HOSPITAL ---> San Pablo City ---> ph
PHILIPPINE HEART CENTER ---> MEDICAL CENTER OF ---> ph
PHILIPPINE ORTHOPEDIC CENTER ---> CENTRAL LUZON, INC. ---> ph
PHILLIPS MEMORIAL HOSPITAL ---> Circumference Road ---> ph
PHILSAGA GENERAL HOSPITAL ---> San Juan, Cabanatuan City ---> ph
PIDDIG DISTRICT HOSPITAL ---> Nueva Ecija ---> ph
PIEDAD MEDICAL CLINIC ---> POLYCLINIC AND HOSPITAL ---> ph
PILAR DISTRICT HOSPITAL ---> Green Vill., Concepcion, Tarlac ---> ph
PILAR MEDICAL AND ---> MARY HOSPITAL ---> ph
PILILLA MEDICARE ---> Raines Virac, Catanduanes ---> ph
PIMENTEL MEDICAL CLINIC ---> Justine Ville II Subd., ---> ph
PINAMALAYAN COMMUNITY HOSPITAL ---> Imus, Cavite ---> ph
PINAMALAYAN DOCTORS HOSPITAL ---> HOSPITAL ---> ph
PIÑAN DISTRICT HOSPITAL ---> Mabinay, Negros Oriental ---> ph
PINES CITY DOCTOR'S HOSPITAL ---> MANAGEMENT CORPORATION ---> ph
PINTUYAN DISTRICT HOSPITAL ---> Isabela City, Basilan ---> ph
PINUKPUK DISTRICT HOSPITAL ---> (formerly Palayan City Emergency Hospital) ---> ph
PIO DURAN MEMORIAL ---> Palayan City, Nueva Ecija ---> ph
PIRA HOSPITAL ---> Ipil, Sibugay, Zamboanga ---> ph
PLACER DISTRICT HOSPITAL ---> Irosin, Sorsogon ---> ph
PLARIDEL COUNTY HOSPITAL ---> Capitol Drive, Balanga City ---> ph
PLARIDEL EMERGENCY HOSPITAL ---> Bataan ---> ph
PNP GENERAL HOSPITAL ---> HOSPITAL ---> ph
PNP REGIONAL HEALTH SERVICES O2 ---> Calinan, Davao City ---> ph
PNP STATION HOSPITAL ---> Baligatan, Ilagan City, Isabela ---> ph
POLILLO MEDICARE HOSPITAL ---> MEMORIAL HOSPITAL ---> ph
POLOMOLOK MUNICIPAL HOSPITAL ---> Argao, Cebu ---> ph
PORAC DISTRICT HOSPITAL ---> CLINIC AND HOSPITAL ---> ph
POTIA DISTRICT HOSPITAL ---> Pagantayan, Cantilan ---> ph
POZORRUBIO COMMUNITY ---> Surigao del Sur ---> ph
PREMIERE GENERAL HOSPITAL ---> Polangui, Albay ---> ph
PREMIERE GENERAL ---> CENTER, INC. ---> ph
PRES. CARLOS P. GARCIA ---> National Highway, Isulan ---> ph
PRES. DIOSDADO MACAPAGAL ---> Sultan Kudarat ---> ph
PRES. DIOSDADO MACAPAGAL ---> Itbayat, Batanes ---> ph
PRES. RAMON MAGSAYSAY ---> Bagueng Tinogdan, Itogon ---> ph
PRES. ROXAS PROV'L. COMMUNITY HOSP. ---> Benguet ---> ph
PRIETO DIAZ MUNICIPAL HOSPITAL ---> Cabrera St., Pagadian City ---> ph
PRIME GLOBAL CARE MEDICAL CTR. ---> Hagonoy, Davao Del Sur ---> ph
PRINCIPE COMMUNITY ---> AND COLLEGES, INC. ---> ph
PUDPUD POLYCLINIC AND ---> 75 Bukidnon St., Bago Bantay ---> ph
PUERTO COMMUNITY HOSPITAL ---> Quezon City ---> ph
PUYAOAN GENERAL HOSPITAL ---> Cagayan de Oro City ---> ph
Q.C. ST. AGNES GEN. OSPITAL ---> Cor. Rivera Zamora, ---> ph
QUEEN MARY HELP OF ---> Dagupan City, Pangasinan ---> ph
QUEEN MARY HOSPITAL ---> Jabonga, Agusan Del Norte ---> ph
QUEENSBERRY HOSPITAL ---> Abadilla Subd., Pob. ---> ph
QUEZON CITY GENERAL HOSPITAL ---> Tacurong City, Sultan Kudarat ---> ph
QUEZON COMMUNITY INFIRMARY ---> HOSPITAL ---> ph
QUEZON INSTITUTE ---> Tabaco City, Albay ---> ph
QUEZON MEDICARE HOSPITAL ---> Pagadian Community Hospital) ---> ph
QUEZON MEDICAL HOSPITAL ---> Bagong Silang, Balangasan District ---> ph
QUIJANO CLINIC AND HOSPITAL ---> Pagadian City, Zamboanga del Sur 24 ---> ph
QUINAPONDAN COMMUNITY ---> HOSPITAL ---> ph
QUIRINO MEMORIAL MEDICAL ---> New Asinan, Olongapo City, ---> ph
QUIRINO PROVINCIAL HOSPITAL ---> C. M. Recto St., ---> ph
R DE C GALVEZ MEDICAL CENTER ---> Pagbilao, Quezon ---> ph
R and L MEDICAL CLINIC ---> MEMORIAL HOSPITAL ---> ph
RTN FOUNDATION HOSPITAL, INC. ---> Banga, South Cotabato ---> ph
R. S. CLINIC AND HOSPITAL ---> (formerly JASAAN HOSPITAL) ---> ph
RABARA CLINIC AND HOSPITAL ---> Jasaan, Misamis Oriental ---> ph
RAFAEL LAZATIN MEMORIAL ---> 73 Dr. Pilapil St., Sagad Street ---> ph
RAGAY DISTRICT HOSPITAL ---> Pasig City ---> ph
RALOTA-LAGRADA MEDICAL ---> Nat'l H-Way, Magsaysay Cordon, ---> ph
RAMIRO COMMUNITY ---> Isabela ---> ph
RAMON MASA SR. MEMORIAL ---> San Nicolas, Tarlac City ---> ph
RAMON TABIANA MEMORIAL ---> HOSPITAL ---> ph
RAMONES GENERAL ---> (formerly Aleosan District Hospital) ---> ph
RAMOS GENERAL HOSPITAL ---> Balasan, Iloilo ---> ph
RANADA GENERAL HOSPITAL ---> CONCEPCION HOSPITAL ---> ph
RAPU-RAPU DISTRICT HOSPITAL ---> Katipunan Avenue ---> ph
RAYOS-VALENTIN HOSPITAL ---> Concepcion, Marikina City ---> ph
RECEL MEDICAL CLINIC ---> Solis St., Lingayen, Pangasinan ---> ph
REDOBLE MEDICAL CLINIC ---> Guiguinto, Bulacan ---> ph
REGION 1 MEDICAL CENTER ---> National Road, Poblacion ---> ph
REINHARD WIRTGEN ---> Pulilan, Bulacan ---> ph
REMEDIOS TRINIDAD ---> Sto. Angel Central ---> ph
RENMAR SPECIALIST HOSPITAL ---> Sta. Cruz, Laguna ---> ph
REP. PEDRO TRONO MEMORIAL ---> Tanza, Cavite ---> ph
RESEARCH INSTITUTE FOR ---> 26 Mariano Ponce cor. Tirad ---> ph
RESONABLE HOSPITAL ---> Pass Street, Caloocan City ---> ph
RETUERMA GENERAL HOSPITAL ---> HOSPITAL ---> ph
REVELO MEDICAL CLINIC ---> Jones, Isabela ---> ph
REYES CLINIC AND HOSPITAL ---> REGIONAL HOSPITAL ---> ph
RICARDO LIMSO MEDICAL ---> Dolores, San Fernando City, ---> ph
RICARDO MANINGO MEMORIAL ---> Pampanga ---> ph
RICARDO P. RODRIGUEZ ---> MEMORIAL HOSPITAL ---> ph
RICO MEDICAL  CLINIC ---> San Ramon, Dinalupihan, Bataan ---> ph
RICO'S HOSPITAL ---> SERVICE COOPERATIVE HOSP. ---> ph
RIDON'S ST. JUDE MEDICAL CENTER ---> Jose Panganiban ---> ph
RILLERA MEDICAL HOSPITAL ---> Camarines Norte ---> ph
RINCONADA MEDICAL CENTER ---> MEDICAL CENTER ---> ph
RIVERA MEDICAL CENTER, INC. ---> Sta. Cruz, Manila ---> ph
RIZAL MEDICAL CENTER ---> MEMORIAL DISTRICT HOSP. ---> ph
RIZAL PROVINCIAL HOSPITAL ---> Tuburan, Ligao, Albay ---> ph
ROA MEDICAL CLINIC ---> #1 Coral, Magallenes St. ---> ph
RODOLFO MORALES MEDICAL CLINIC ---> Paniqui, Tarlac ---> ph
ROEL I. SENADOR, MD ---> HOSPITAL ---> ph
ROGACIANO H. MERCADO ---> Isabela City, Basilan ---> ph
ROLDAN MEDICAL CLINIC ---> HOSPITAL ---> ph
ROMANA PANGAN DISTRICT ---> San Andres, Catanduanes ---> ph
ROMEL CRUZ HOSPITAL ---> HOSPITAL ---> ph
ROMEO B. SIBUD COUNTY ---> Sogod, Cebu ---> ph
ROMBLON DISTRICT ---> Rizal, Kalinga ---> ph
ROMBLON PROVINCIAL ---> MEMORIAL HOSPITAL ---> ph
ROMUALDEZ-KATIKU ---> Sta. Maria, Ilocos Sur ---> ph
ROQUERO HOSPITAL ---> MEMORIAL HOSPITAL ---> ph
ROSARIO MEMORIAL HOSPITAL ---> Dalaguete, Cebu ---> ph
ROSARIO-TRINIO MEDICAL ---> MEMORIAL HOSPITAL (formerly ---> ph
ROSARY OF VIRGIN MARY ---> Gov. Leandro Fullon District Hospital) ---> ph
ROXAS DISTRICT HOSPITAL ---> Pandan, Antique ---> ph
ROXAS MEDICARE HOSPITAL ---> MOTHER AND CHILD HOSPITAL ---> ph
ROXAS MEMORIAL PROVINCIAL ---> Binondo, Manila ---> ph
RUGAY MATERNITY AND ---> 5001 Gen. T. De Leon 120 ---> ph
SDS MEDICAL CENTER ---> Mc Arthur Hi-way, Valenzuela City ---> ph
SMD GENERAL HOSPITAL ---> SPECIALIST HOSPITAL ---> ph
S.M. LAO MEMORIAL CITY ---> Kabacan, North Cotabato ---> ph
SS LUMAPAS HOSPITAL ---> COOPERATIVE HOSPITAL ---> ph
SSMC- SATELITE HOSPITAL ---> Osias. Kabacan, North Cotabato ---> ph
SSMC - SATELLITE HOSPITAL - ---> Brgy. Tabugon, Kabankalan City ---> ph
SABAL HOSPITAL INC. ---> Negros Occidental ---> ph
SABALLA-ROSARIO HOSPITAL ---> Kabasalan, Sibugay, Zamboanga ---> ph
SABATER HOSPITAL ---> Kabasalan, Zamboanga del Sur ---> ph
SABTANG COMMUNITY HOSPITAL ---> GENERAL HOSPITAL ---> ph
SANCTISSIMO ROSARIO GEN. HOSPITAL ---> Muzon, San Jose Del Monte City ---> ph
SACRED HEART HOSPITAL ---> Bulacan ---> ph
SACRED HEART HOSPITAL ---> Kalamansag, Sultan Kudarat ---> ph
SACRED HEART MEDICAL CENTER ---> Lubuagan, Kalinga ---> ph
SACRED HEART MEDICAL ---> Bulanao, Tabuk, Kalinga ---> ph
SAGRADA FAMILIA HOSPITAL ---> PRIMARY HOSPITAL ---> ph
SAGRADO MEDICAL & ---> Bayawan, Negros Oriental ---> ph
SALAZAR POLYCLINIC ---> Kananga, Northern Leyte ---> ph
SALCEDO MEDICARE & ---> Kapalong, Davao del Norte ---> ph
SALOMON MANGILET ---> COMMUNITY HOSPITAL ---> ph
SALUG VALLEY MEDICAL CENTER ---> Kapangan, Benguet ---> ph
SALVACION CLINIC ---> HOSPITAL ---> ph
SALVACION OPPUS YNIGUEZ MEMORIAL ---> Kapatagan, Lanao Del Sur ---> ph
SALVADOR GENERAL HOSPITAL ---> Kasibu, Nueva Viscaya ---> ph
SALVE REGINA GENERAL ---> Kauswagan, Lanao del Norte ---> ph
SAMAL DISTRICT HOSPITAL ---> Kawit, Cavite ---> ph
SAMAR PROVINCIAL HOSPITAL ---> HOSPITAL ---> ph
SAMPALOC MEDICARE ---> Kawit, Cavite ---> ph
SAN ANDRES MUNICIPAL ---> Kiamba, Saranggani ---> ph
SAN ANTONIO DISTRICT ---> Kidapawan City ---> ph
SAN ANTONIO DISTRICT ---> Quezon Blvd., Poblacion, ---> ph
SAN ANTONIO MEDICAL ---> Kidapawan City ---> ph
SAN CARLOS CITY HOSPITAL ---> SPECIALIST CENTER, INC. ---> ph
SAN CARLOS DOCTORS ---> Sudapin, Kidapawan City ---> ph
SAN DIEGO DE ALCALA ---> Kisolon, Sumilao, Bukidnon ---> ph
SAN DIEGO GENERAL HOSPITAL ---> Kitcharao, Agusan del Norte ---> ph
SANDIG MEDICAL CLINIC ---> Kolambugan, Lanao del Norte ---> ph
SAN FERNANDINO HOSPITAL ---> Labangan, Zamboanga Del Sur ---> ph
SAN FRANCISCO MUNICIPAL ---> Ubay, Bohol ---> ph
SAN GERONIMO GENERAL HOSPPITAL ---> La Paz, Abra ---> ph
SAN ISIDRO HOSPITAL ---> COMMUNITY HOSPITAL ---> ph
SAN JOSE CITY GENERAL HOSPITAL ---> San Roque, La Paz, Tarlac ---> ph
SAN JOSE DISTRICT HOSPITAL ---> La Paz, Agusan del Sur ---> ph
SAN JOSE DISTRICT HOSPITAL ---> CENTER AND HOSPITAL ---> ph
SAN JOSE DISTRICT HOSPITAL ---> San Fernando City,La Union ---> ph
SAN JOSE HOSPITAL AND ---> (formerly Doña Gregoria ---> ph
SAN JOSE HOSPITAL AND ---> Memorial Hospital) ---> ph
SAN JOSE MEDICARE ---> Nazareno, Agoo, La Union ---> ph
SAN JUAN BAUTISTA HOSPITAL ---> M.L. Quezon St., Pob. ---> ph
SAN JUAN DE DIOS ---> Valencia City, Bukidnon ---> ph
SAN JUAN DISTRICT HOSPITAL ---> San Vicente, Compustela Valley ---> ph
SAN JUAN DOCTOR'S HOSPITAL, INC. ---> (LILOY MEDICARE HOSPITAL) ---> ph
SAN JUAN MEDICAL CENTER ---> Liloy, Zamboanga del Norte ---> ph
SAN LAZARO HOSPITAL ---> Labo, Camarines Norte ---> ph
SAN LORENZO HOSPITAL HEALTH ---> Pob. Labrador, Pangasinan ---> ph
SAN LORENZO HOSPITAL HEALTH ---> Labuan, Zamboanga City ---> ph
SAN LORENZO RUIZ ---> OF CAYBIGA, INC. ---> ph
SAN LUIS DISTRICT HOSPITAL ---> 15 Gen. Luis St., Caybiga ---> ph
SAN MARCELINO DISTRICT ---> Caloocan City ---> ph
SAN MARIANO MEDICARE ---> P Guevara St., Sta. Cruz, Laguna ---> ph
SAN MIGUEL COMMUNITY ---> (formerly HOLY FAMILY CLINIC) ---> ph
SAN MIGUEL DISTRICT HOSPITAL ---> Sta. Cruz, Laguna ---> ph
SAN MIGUEL MUNICIPAL ---> Sta.Cruz, Laguna ---> ph
SAN NARCISO MUNICIPAL ---> Vigan, Ilocos Sur ---> ph
SAN PABLO CITY GENERAL ---> Lake Sebu, South Cotabato ---> ph
SAN PABLO COLLEGES ---> Maligaya, Lambayong, ---> ph
SAN PABLO DOCTORS HOSPITAL ---> Sultan Kudarat ---> ph
SAN PASCUAL BAYLON MATERNITY ---> PROVINCIAL HOSPITAL ---> ph
SAN PEDRO HOSPITAL OF ---> Sagadan Baroy, Lanao Del Norte ---> ph
SAN PEDRO MUNICIPAL HOSPITAL ---> Imelda Sibugay, Zamboanga ---> ph
SAN RAMON HOSPITAL ---> Surralah, South Cotabato ---> ph
SAN ROQUE HOSPITAL ---> Languyan, Tawi-Tawi ---> ph
SAN ROQUE MEDICAL CLINIC ---> 46 Brgy. Nalbo Laoag City ---> ph
SAN SEBASTIAN DISTRICT HOSPITAL ---> Ilocos Norte ---> ph
SAN VICENTE DISTRICT HOSPITAL ---> Andres Castro St., Laoag City ---> ph
SANTIAGO'S PEDIATRIC HOSPITAL ---> Lapu-Lapu City, Cebu ---> ph
SANTISSIMA TRINIDAD HOSPITAL ---> Surralah, South Cotabato ---> ph
SANTISSIMA TRINIDAD ---> Pob. Las Nieves, ---> ph
SANCTISSIMO ROSARIO ---> Agusan del Norte ---> ph
SANTOS GENERAL HOSPITAL ---> Talon V, Las Piñas City ---> ph
SARANGANI MUNICIPAL ---> CRM Ave., BF Homes, Almanza ---> ph
SAROMA HOSPITAL ---> Las Piñas CIty ---> ph
SCHISTOSOMIASIS HOSPITAL ---> LAS PIÑAS GEN. HOSPITAL ---> ph
SEAMEN'S HOSPITAL ---> Pulang Lupa I, Las Piñas City ---> ph
SEBASTE COMMUNITY HOSPITAL ---> Lasam, Cagayan Valley ---> ph
SEMIRARA COAL CORP. HOSP. ---> HOSPITAL ---> ph
SEN. GERARDO M. ROXAS ---> Santor Tanauan, Batangas ---> ph
SEN. NINOY AQUINO ---> Brgy. Ticub, Laurel, Batangas ---> ph
SEÑOR STO. NIÑO HOSPITAL ---> COMMUNITY HOSPITAL ---> ph
SEÑOR STO. NIÑO HOSPITAL, INC. ---> Lazi, Siquijor ---> ph
SEÑOR TESORO HOSPITAL ---> COMMUNITY HOSPITAL ---> ph
SEVERO VERALLO MEMORIAL ---> Salaman, Lebak, Sultan Kudarat ---> ph
SIARGAO DISTRICT HOSPITAL ---> Rizal Avenue, Lebak ---> ph
SIASI DISTRICT HOSPITAL ---> Sultan Kudarat ---> ph
SIBUTAD MUNICIPAL HOSPITAL ---> Pob. Lebak, Sultan Kudarat ---> ph
SIBUYAN DISTRICT HOSPITAL ---> R. Diokno St., Lemery, Batangas ---> ph
SILANG GENERAL HOSPITAL ---> MEMORIAL HOSPITAL ---> ph
SILLIMAN MEDICAL CENTER ---> Daet, Camarines Norte ---> ph
SILVA'S CLINIC ---> MINING HOSPITAL ---> ph
SIMBULAN STO. NIÑO HOSPITAL ---> Makayan, Benguet ---> ph
SINAIT DISTRICT HOSPITAL ---> LEONA O. LIM MEMORIAL ---> ph
SINAWILAN CLINIC & HOSPITAL ---> HOSPITAL ---> ph
SINDANGAN DISTRICT HOSP. ---> Brgy. Pangobilian, Brooke's Point ---> ph
SING MEDICAL SERVICES DIAGNOSTIC ---> Palawan ---> ph
SIPOCOT DISTRICT HOSPITAL ---> HOSPITAL ---> ph
SIRUMA MUNICIPAL HOSPTAL ---> Catarman, Northern Samar ---> ph
SIQUIJOR PROVINCIAL ---> Hilongos, Leyte ---> ph
SOCORRO DISTRICT HOSPITAL ---> Candahug, Palo, Northern Leyte ---> ph
SOGOD DISTRICT HOSPITAL ---> Lianga, Surigao del Sur ---> ph
SOHAYA MEDICAL AND ---> Malinao, Albay ---> ph
SOLER GENERAL HOSPITAL ---> Sawang, Guindulman, Bohol ---> ph
SOLLER GENERAL HOSPITALP ---> Libmanan, Camarines Sur ---> ph
SOLOMON'S HOSPITAL ---> Isabel, Leyte ---> ph
SOMOSO GENERAL HOSPITAL ---> Liloan, Southern Leyte ---> ph
SORIANO LEYBLE MEDICAL ---> DISTRICT HOSPITAL ---> ph
SORILLA MEDICAL AND ---> Liloy, Zamboanga City ---> ph
SORSOGON MEDICAL ---> Jagna, Bohol ---> ph
SOUTH COTABATO ---> Lingig, Surigao del Sur ---> ph
SOUTH DAVAO MEDICAL ---> Lipa City, Batangas ---> ph
SOUTH M'LANG MEDICAL CLINIC ---> Rizal St., Lipa City ---> ph
SOUTH SUPERHIGHWAY ---> Balintawak Lipa City ---> ph
SOUTH UPI MUNICIPAL HOSP. ---> Gingoog City, ---> ph
SOUTHERN ISABELA ---> Cagayan de Oro City ---> ph
SOUTHERN LUZON HOSPITAL ---> HOSPITAL ---> ph
SOUTHERN NEGROS ---> Elustre Ave., Lemery, Batangas ---> ph
SOUTHERN PALAWAN ---> A Mayo St., Pob ll, ---> ph
SOUTHERN PHILIPPINES MEDICAL ---> Tiaong, Quezon ---> ph
SPECIALIST GROUP HOSP. ---> Digos City, Davao del Sur ---> ph
ST. ANDREW HOSPITAL ---> Llorente, Eastern Samar ---> ph
ST. ANN MEDICAL HOSPITAL ---> Fabrica Lobo, Batangas ---> ph
ST. ANNE CLINIC ---> Sagay City, Western Visayas ---> ph
ST. ANNE GENERAL HOSPITAL, INC. ---> Mangatarem, Pangasinan ---> ph
ST. ANTHONY COLLEGE ---> HOSPITAL CORP ---> ph
ST. ANTHONY MOTHER ---> Real St., Lopez, Quezon ---> ph
ST. ANTHONY OF MARIKINA ---> Loreto, Surigao del Norte ---> ph
ST. CAMILLUS HOSPITAL ---> Loreto, Agusan del Sur ---> ph
ST. CAMILLUS HOSPITAL ---> Carlatan, San Fernado City ---> ph
ST. CATHERINE HOSPITAL ---> La Union ---> ph
ST. CATHERINE OF ALEXANDRIA ---> Kabankalan City ---> ph
ST. CECILIA HOSPITAL ---> Negros Occidental ---> ph
ST. CHRISTIANA MATERNITY ---> Los Baños, Laguna ---> ph
ST. CLAIRE HOSPITAL ---> Iriga City ---> ph
ST. CLAIRE'S MEDICAL CENTER ---> Kayapa, Nueva Viscaya ---> ph
ST. CLEMENT MEDICAL CLINIC ---> National Highway, Tacurong City ---> ph
ST. DOMINIC MEDICAL ---> Sultan Kudarat ---> ph
ST. FELIX MEDICAL HOSPITAL ---> Lubang, Occidental Mindoro ---> ph
ST. FRANCES CABRINI ---> Magsaysay, Alicia, Isabela ---> ph
ST. FRANCIS OF ASSISI MATERNITY ---> (formerly Dr. Francisco Faller ---> ph
ST. GABRIEL HOSPITAL ---> Memorial Hosp.) Lucban, Quezon ---> ph
ST. JAMES HOSPITAL ---> Ibabang Dupay Red V, ---> ph
ST. JAMES HOSPITAL AND ---> Lucena City, Quezon ---> ph
ST. JAMES HOSPITAL, INC. ---> Brgy. Isabang, Lucena City, ---> ph
ST. JAMES THE GREATER ---> Quezon ---> ph
ST. JOHN GENERAL ---> Daraga, Albay ---> ph
ST. JOHN HOSPITAL ---> REGIONAL HOSPITAL ---> ph
ST. JOHN HOSPITAL ---> Bauko, Mt. Province ---> ph
ST. JOHN HOSPITAL, INC. ---> Pob. 3 Clarin, Misamis Occidental ---> ph
ST. JOHN MEDICAL AND ---> Luisiana, Laguna ---> ph
ST. JOHN THE APOSTLE ---> Oas, Albay ---> ph
ST. JOHN THE BAPTIST ---> Calapan City, Oriental Mindoro ---> ph
ST. JOSEPH MEDICAL CLINIC ---> Quezon Avenue, Quezon City ---> ph
ST. JOSEPH MEDICAL CLINIC ---> Lupon, Davao Oriental ---> ph
ST. JOSEPH SOUTHERN ---> AND FOUNDATION INC. ---> ph
ST. JUDE CLINIC AND HOSPITAL ---> (former Lutheran Hospital) ---> ph
ST. JUDE CLINIC AND HOSPITAL ---> Baguis, Benguet ---> ph
ST. JUDE FAMILY HOSPITAL ---> Luuk, Sulu ---> ph
ST. JUDE HOSPITAL AND ---> PRIMARY HOSPITAL ---> ph
ST. JUDE HOSPITAL OF LABO ---> Guihulngan, Negros Oriental ---> ph
ST. JUDE MEDICAL CLINIC ---> Tapuac District, Dagupan City ---> ph
ST. JUDE'S HOSPITAL, INC. ---> Macanaya, Aparri, Cagayan ---> ph
ST. JUDE THADDEUS WOMEN ---> CITY GENERAL HOSPITAL ---> ph
ST. LAWRENCE HOSPITAL ---> Maharlika Rd., Cabanatuan City ---> ph
ST. LOUIS MEDICAL CLINIC ---> Sta. Rita, Concepcion, Tarlac ---> ph
ST. LOUIS UNIVERSITY HOSP. ---> Brgy. De Ocampo ---> ph
ST. LUKE'S MEDICAL CENTER ---> Trece Martirez, Cavite ---> ph
ST. LUKE'S MEDICAL CENTER ---> Ipil, Zamboanga Sibugay ---> ph
ST. MAGDALENE HOSPITAL ---> FOUNDATION HOSPITAL ---> ph
ST. MARTIN DE PORRES ---> Edsa, Caloocan City ---> ph
ST. MARTIN DE PORRES ---> SERVICES COOPERATIVE ---> ph
ST. MARTIN DE PORRES ---> OF ORIENTAL MINDORO ---> ph
ST. MARTIN MATERNITY & ---> Tawiran, Calapan City, ---> ph
ST. MARTIN'S MISSION HOSPITAL ---> Oriental Mindoro ---> ph
ST. MARY OF LOURDES ---> SERVICES COOP. PUERTO ---> ph
ST. MARY'S MATERNITY AND ---> PRINCESA CHAPTER ---> ph
ST. MARY'S MEDICAL SERVICES, ---> #14 Taft St., Puerto Princesa City ---> ph
ST. MATTHEWS MEDICAL HOSPITAL ---> 38 Nat'l Rd. Putatan, ---> ph
ST. MAZENOD HOSPITAL ---> Muntinlupa City ---> ph
ST. MICHAEL FAMILY HOSPITAL ---> Tawiran Calapan City, ---> ph
ST. MICHAEL GENERAL HOSPITAL ---> Oriental Mindoro ---> ph
ST. MICHAEL MEDICAL CENTER ---> Chino Roces Ave., cor. Solchuaga ---> ph
ST. NAZARIUS MEDICAL CLINIC ---> Makati City ---> ph
ST. NICHOLAS DOCTORS ---> Maasim, Sarangani ---> ph
ST. PATRICK'S HOSPITAL AND ---> Mabalacat, Pampanga ---> ph
ST. PAUL GENERAL HOSPITAL ---> CUMMUNITY HOSPITAL ---> ph
ST. PAUL'S HOSPITAL ---> Mabinay, NEgros Oriental ---> ph
ST. PAUL'S HOSPITAL ---> Macabebe, Pampanga ---> ph
ST. PAUL HOSPITAL CAVITE, INC. ---> Basak, Lapu-Lapu City ---> ph
ST. PAUL HOSPITAL OF ---> Maddela, Quirino ---> ph
ST. PETER CLAVER HOSPITAL ---> Carmen, Cagayan de Oro City ---> ph
ST. PETER GENERAL HOSPITAL ---> Balayan, Batangas ---> ph
ST. RAFHAEL HOSPITAL ---> HOSPITAL, INC. ---> ph
ST. RAPHAEL FOUNDATION ---> Lanao St., Kidapawan City ---> ph
ST. THEODORE'S HOSPITAL ---> Madrid, Surigao del Sur ---> ph
ST. THERESA WELLNESS ---> COMMUNITY HOSPITAL ---> ph
ST. THERESE HOSPITAL ---> Magallanes, Sorsogon ---> ph
ST. THERESE-MTC COLLEGES ---> (former Gonzales - Advincula Med Clinic) ---> ph
ST. THERESE OF THE ---> Sta Maria, Davao Del Sur ---> ph
ST. THOMAS AQUINAS HOSPITAL ---> HOSPITAL, INC. ---> ph
ST. VICTORIA HOSPITAL ---> Guiguinto, Bulacan ---> ph
ST. VINCENT DE FERRER HOSP. ---> Buluan, Maguindanao ---> ph
ST. VINCENT DE PAUL COLLEGE ---> DISTRICT HOSPITAL ---> ph
ST. VINCENT DE PAUL HOSPITAL ---> Lopez, Quezon ---> ph
ST. VINCENT EENT HOSPITAL ---> Magsingal, Ilocos Sur ---> ph
ST. VINCENT GENERAL HOSPITAL - CEBU CITY ---> HOSPITAL ---> ph
ST. VINCENT HOSPITAL ---> Shariff Aguak, Maguindanao ---> ph
ST. VINCENT HOSPITAL ---> STO. ROSARIO DISTRICT HOSPITAL ---> ph
ST. VINCENT MEDICAL CLINIC ---> (formerly M.V.M. Sto. Rosario ---> ph
STA. ANA COMMUNITY HOSPITAL ---> Municipal Hospital) ---> ph
STA. ANA HOSPITAL ---> Rosario, Batangas ---> ph
STA. CECILIA MEDICAL CENTER ---> Mahayag, Zamboanga del Sur ---> ph
STA. CLARA DE MONTEFALCO ---> COOPERATIVE ---> ph
STA. CRUZ COMMUNITY HOSPITAL ---> Lakandula St., Poblacion ---> ph
STA. CRUZ DISTRICT HOSPITAL ---> Mariveles, Bataan ---> ph
STA. CRUZ HOSPITAL ---> HOSPITAL ---> ph
STA. CRUZ LAGUNA POLYMEDIC INC. ---> Mainit, Surigao del Norte ---> ph
STA. ISABEL GENERAL ---> Maitum, Sarangani ---> ph
STA. LUCIA DISTRICT HOSPITAL ---> Majayjay, Laguna ---> ph
STA. MARCELA DISTRICT HOSPITAL ---> AIR BASE HOSPITAL ---> ph
STA. MARIA MEDICAL CLINIC ---> Sangley Point, Cavite ---> ph
STA. MARIA VILLAGE CLINIC ---> 2 Amorsolo St., Makati City ---> ph
STA. MARIA JOSEFA ---> HOSPITAL, INC. ---> ph
STA. MONICA HOSPITAL ---> Makilala, North Cotabato ---> ph
STA. MONICA MUNICIPAL ---> Malasiqui, Pangasinan ---> ph
STA. RITA DE BACLARAN HOSPITAL ---> Saypon Highway, Toril ---> ph
STA. ROSA COMMUNITY ---> Davao City ---> ph
STA. ROSA COMMUNITY ---> Malay, Aklan ---> ph
STA. ROSA HOSPITAL & ---> Fortichst Brgy.Malaybalay City ---> ph
STA. TERESITA HOSPITAL, INC. ---> Bukidnon ---> ph
STA. TERESITA GENERAL ---> GENERAL HOSPITAL ---> ph
STO. DOMINGO DISTRICT ---> Fortichst, Brgy. Malaybalay City ---> ph
STO. NIÑO DE CASIPIT HOSPITAL ---> Bukidnon ---> ph
STO. NIÑO HOSPITAL ---> Malimono, Surigao del Norte ---> ph
STO. NIÑO HOSPITAL ---> Corcuera, Romblon ---> ph
STO. NIÑO HOSPITAL ---> Malita, Davao del Sur ---> ph
STO. NIÑO OF PHILEX ---> HOSPITAL & EYE CENTER ---> ph
STO. NIÑO MEDICAL CLINIC ---> McArthur H-way, Malolos, Bulacan ---> ph
STO. ROSARIO HOSPITAL ---> COUNTY HOSPITAL ---> ph
STO. ROSARIO MATERNITY ---> Brgy. Canalate, Malolos, Bulacan ---> ph
STO. TOMAS GENERAL HOSPITAL ---> Toril, Davao City ---> ph
STO. TOMAS UNIVERSITY ---> Malungon, Sarangani ---> ph
STO. TOMAS MUNICIPAL HOSPITAL ---> Mambusao, Capiz ---> ph
STS. FRANCIS AND PAUL ---> GENERAL HOSPITAL ---> ph
STS. PETER AND PAUL HOSPITAL ---> San Matias, Sto. Tomas, ---> ph
SUERO GENERAL HOSPITAL ---> Pampanga ---> ph
SULOP MEDICAL CLINIC ---> Buluan, Maguindanao ---> ph
SULTAN KUDARAT DOCTORS ---> Nat'l. Hi-way, San Antonio ---> ph
SULTAN KUDARAT MEDICAL ---> Alicia, Isabela ---> ph
SULTAN KUDARAT ---> Manaoag, Pangasinan ---> ph
SULTAN NAGA DIMAPORO PROV''L ---> Sta. Maria, Manay ---> ph
SULU MEDICAL SPECIALISTS HOSPITAL ---> Davao Oriental ---> ph
SULU PROVINCIAL HOSPITAL ---> MEDICAL CENTER ---> ph
SULU SANITARIUM HOSPITAL ---> Boni Avenue, Mandaluyong City ---> ph
SUNGA HOSPITAL ---> COMMUNITY HOSPITAL ---> ph
SURIGAO MEDICAL CENTER, INC ---> Mandaon, Masbate ---> ph
SURRALAH COMMUNITY ---> Mangatarem, Pangasinan ---> ph
SUSANO UY MEMORIAL HOSPITAL INC. ---> CENTER AND SCHOOL OF ---> ph
SWU-ARGAO COMMUNITY HOSPITAL ---> MEDICAL ARTS INC. ---> ph
TAAL POLYMEDIC HOSPITAL AND ---> 1975Donada St.,Pasay City ---> ph
TABACO COLLEGE HOSPITAL ---> 667 UN Avenue, Ermita, Manila ---> ph
TABANGO COMMUNITY ---> Manila East Rd., Bgy. Dolores ---> ph
TABLAS ISLAND DISTRICT ---> Taytay, Rizal ---> ph
TABLAS DOCTOR'S HOSPITAL ---> Fort Bonifacio, Taguig City ---> ph
TABUK FAMILY CLINIC ---> Manito, Albay ---> ph
TACLOBAN CITY HOSPITAL ---> Mansalay, Oriental Mindoro ---> ph
TAFT DISTRICT HOSPITAL ---> Lanao St., Kidapawan City ---> ph
TAGALOAN POLYMEDIC ---> Roxas, Isabela ---> ph
TAGAYTAY HOSPITAL AND ---> Montillana Blvd., Butuan City ---> ph
TAGBILARAN COMMUNITY ---> COMMUNITYHOSPITAL ---> ph
TAGBILARAN MATERNITY AND ---> Manukan, Zamboanga del Norte ---> ph
TAGUIG DOCTORS' HOSPITAL ---> Mapandan, Pangasinan ---> ph
TAGUDIN GENERAL HOSPITAL ---> 048 Buanda Boulevard Saduc ---> ph
TAGUIG-PATEROS DISTRICT HOSPITAL ---> Marawi City, Lanao Del Sur ---> ph
TAGUM DOCTORS HOSPITAL ---> Publacion Quezon, Bukidnon ---> ph
TALAVERA EXTENSION HOSPITAL ---> HOSPITAL ---> ph
TALISAY DISTRICT HOSPITAL ---> Maragusan, Compostela Valley ---> ph
TALON GENERAL HOSPITAL ---> LABORATORY (formerly MARAMAG ---> ph
TAMOLA-TAN MEDICAL HOSPITAL ---> MEDICAL CLINIC) ---> ph
TAMONDONG MEMORIAL ---> Maramag, Bukidnon ---> ph
TAMONDONG-DELOS ---> Fernan Subd., Maranding Lala, ---> ph
TAMPARAN DISTRICT HOSPITAL ---> Lanao Del Norte ---> ph
TAMPARAN MEDICAL FOUNDATION, INC. ---> 237 M. Ponce St., Baliuag ---> ph
TANAY COMMUNITY HOSPITAL ---> Bulacan ---> ph
TANAY GENERAL HOSPITAL ---> AND MEDICAL HOSPITAL ---> ph
TANCHULING HOSPITAL ---> Banga I. Plaridel, Bulacan ---> ph
TANHO MEDICAL CLINIC ---> HOSPITAL ---> ph
TANZA FAMILY GENERAL ---> Margosatubig, Zamboanga del Sur ---> ph
TAPAZ DISTRICT HOSPITAL ---> DISITRICT HOSPITAL (formerly ---> ph
TARANGNAN COMMUNITY ---> Tagkawayan District Hosp.) ---> ph
TARLAC PROVINCIAL HOSPITAL ---> Tagkawayan, Quezon ---> ph
TARONGOY MEDICAL CLINIC ---> HOSPITAL ---> ph
TAYABAS COMMUNITY ---> Don Chino Roces Ave., ---> ph
TAYTAY DISTRICT HOSPITAL ---> Makati City ---> ph
TAYTAY EMERGENCY ---> Cagayan de Oro City ---> ph
TAYUG FAMILY HOSPITAL ---> Brgy. Tagapo, Sta. Rosa City, ---> ph
TEODORO B. GALAGAR ---> Laguna ---> ph
TERESITA L. JALANDONI ---> MEMORIAL HOSPITAL ---> ph
THE BLACK NAZARENE ---> Malabuyoc, Cebu City ---> ph
THE DOCTOR'S HOSPITAL, INC. ---> HOSPITAL & MEDICAL CENTER ---> ph
THE FAMILY CLINIC ---> Batac, Ilocos Norte ---> ph
THE LORD'S HOSPITAL ---> Marihatag, Surigao del Sur ---> ph
THE MEDICAL CITY ---> GENERALHOSPITAL, INC. ---> ph
THE MOTHER REGINA MEDICAL FACILITIES ---> Concepcion, Marikina City ---> ph
THE ROSS MAURICIO ---> Sumulong Hi-way Cor., ---> ph
TICAO DISTRICT HOSPITAL ---> Aguinaldo Ave., Marikina City ---> ph
TIGLAO MEDICAL CENTER ---> Almar Subd., Kalookan City ---> ph
TINAMBAC MEDICARE ---> HOSPITAL ---> ph
TINAMBAC MUNICIPAL INFIRMARY ---> Maribojoc, Bohol ---> ph
TINOC DISTRICT HOSPITAL ---> PLANTATION, INC. (MEPI) ---> ph
TOJONG INC. MATERNITY ---> MEDICAL CLINIC / HOSPITAL ---> ph
TOLEDO CITY GENERAL HOSPITAL ---> Sto. Tomas, Davao del Norte ---> ph
TOLENTINO CLINIC & HOSPITAL ---> HOSPITAL (formerly Cuenca ---> ph
TOMAS LACHICA DISTRICT ---> Medicare Community Hosp.) ---> ph
TOMAS-CACAL MEDICAL ---> Cuenca, Batangas ---> ph
TOMBOC-SALAYOG HOSPITAL ---> 198 A. Mabini St., Maypajo, ---> ph
TONDO MEDICAL CENTER ---> Caloocan City ---> ph
TORRIJOS MUNICIPAL ---> 667 Gastambide St., ---> ph
TRINITY WOMAN AND CHILDREN ---> Sampaloc, Manila ---> ph
TRIUMPH OF THE CROSS HOSPITAL ---> MATERNITY HOSPITAL ---> ph
TUAN LIGADDUNG LIPAE ---> Sto. Rosario, Malolos, Bulacan ---> ph
TUAO DISTRICT HOSPITAL ---> E. Rodriguez Ave., ---> ph
TUBIGON COMMUNITY ---> Bagong Ilog, Pasig City ---> ph
TUBOD COMMUNITY HOSPITAL ---> 1221Juan Nolasco St. ---> ph
TUBURAN DISTRICT HOSPITAL ---> Tondo, Manila ---> ph
TUDELA MUNICIPAL HOSPITAL ---> CENTER ---> ph
TUGON MEDICAL CLINIC ---> Lipa City, Batangas ---> ph
TUGUEGARAO CITY PEOPLE'S ---> GEN. HOSPITAL FOUNDATION INC. ---> ph
TUMAUINI COMMUNITY HOSP. ---> Sto. Niño, Plaridel, Bulacan ---> ph
TUY GENERAL HOSPITAL ---> Rosero St., Masbate City ---> ph
UERM MEMORIAL MEDICAL CENTER ---> Masbate, Masbate ---> ph
UMALI MEDICAL CLINIC ---> Digos City, Davao del Sur ---> ph
UMINGAN MEDICARE & ---> HOSPITAL ---> ph
UNAYAN DISTRICT HOSPITAL ---> Pob., Mataas na Kahoy, Batangas ---> ph
UNCIANO GENERAL HOSPITAL ---> AND GENERAL HOSPITAL, INC. ---> ph
UNCIANO MEDICAL CENTER ---> Bagbaguin, Sta. Maria, Bulacan ---> ph
UNISAN MEDICARE ---> National Highway, Isulan ---> ph
UNITED BALAGTAS DOCTORS ---> Isulan, Sultan Kudarat ---> ph
UNITED CANDELARIA DOCTORS ---> HOSPITAL ---> ph
UNITED DOCTOR'S HOSPITAL ---> Camalaniugan, Cagayan ---> ph
UNITED DOCTORS MEDICAL ---> COMMUNITY HOSPITAL ---> ph
UNITED DOCTORS MEDICAL ---> Matnog, Sorsogon ---> ph
UNITED DOCTORS HOSPITAL OF ---> AND HOSPITAL ---> ph
UPH DR. JOSE G. TAMAYO ---> Sto. Tomas, Davao del Norte ---> ph
UNIVERSITY HEALTH SERVICE ---> Mauban, Quezon ---> ph
UNIVERSITY OF PERPETUAL ---> HOSPITAL ---> ph
UNIVERSITY OF SOUTHERN ---> Mawab, Compostela Valley ---> ph
UNTALAN GENERAL HOSPITAL ---> REGIONAL TRAINING AND ---> ph
UP HEALTH SERVICES ---> TEACHING HOSPITAL ---> ph
URDANETA SACRED ---> Maningcal, Ozamis City ---> ph
URDUJA GENERAL HOSPITAL ---> MEMORIAL HOSPITAL ---> ph
USI-MOTHER SETON HOSPITAL ---> Sindangan, Zamboanga del Norte ---> ph
UY MEDICAL CLINIC ---> Mayoyao, Ifugao ---> ph
V. L. MAKABALI MEMORIAL ---> DOCTORS HOSPITAL ---> ph
VALDERRAMA MUNICIPAL ---> Maybunga, Pasig City ---> ph
VALDEZ MOTHER AND CHILD ---> COOP. HOSPITAL ---> ph
VALDEZ-PADRON HOSPITAL ---> Digos, Davao del Sur ---> ph
VALENCIA MEDICAL HOSPITAL ---> Imus, Cavite ---> ph
VALENCIA SANITARIUM ---> 1122 Gen. Luna, Ermita, Manila ---> ph
VALENZUELA CITY EMERGENCY ---> Dr. A. Santos Ave. ---> ph
VALENZUELA MEDICAL CENTER ---> Sucat Road, Parañaque City ---> ph
VALERA MEDICAL HOSPITAL ---> A. B. Fernandez East, ---> ph
VALLADOLID DISTRICT HOSPITAL ---> Dagupan City ---> ph
VELASQUEZ MEDICAL CLINIC ---> HOSPITAL & HEALTH SERVICES ---> ph
VELASCO HOSPITAL ---> COOP - BOHOL ---> ph
VETERANS MEMORIALMEDICAL CENTER ---> Tagbilaran City, Bohol ---> ph
VETERANS REGIONAL HOSPITAL ---> HOSPITAL & HEALTH SERVICES ---> ph
VIACRUSIS MEDICAL CLINIC ---> COOPERATIVE OF DAVAO CITY ---> ph
VIAN FAMILY HOSPITAL ---> Leon Garcia St., Sta Ana ---> ph
VICENTE GULLAS ---> Davao City ---> ph
VICENTE GUSTILO DISTRICT ---> HOSPITAL & HEALTH SERVICES ---> ph
VICENTE PERALTA MEMORIAL ---> COOP-NUEVA VIZCAYA ---> ph
VICENTE SOTTO MEMORIAL ---> Solano, Nueva Vizcaya ---> ph
VIGA DISTRICT HOSPITAL ---> AND HEALTH SERVICES ---> ph
VIGAN POLYCLINIC ---> COOPERATIVE OF TACURONG ---> ph
VILLABA COMMUNITY HOSPITAL ---> Tacurong City, Sultan Kudarat ---> ph
VILLAFLOR'S CLINIC ---> AND HEALTH SERVICES OF TAGUM ---> ph
VILLAROSA HOSPITAL ---> Visayan Village, Tagum City, ---> ph
VILLASIS POLYMEDIC HOSPITAL ---> Davao del Norte ---> ph
VILLAVICIOSA MEDICARE AND ---> HOSPITAL-JIMENEZ ---> ph
VINTAR DISTRICT HOSPITAL ---> Poblacion Jimenez, ---> ph
VIRGEN MILAGROSA ---> Misamis Occidnetal ---> ph
VISAYAS COMMUNITY ---> Roxas St., Valencia City, Bukidnon 10 ---> ph
VSU HOSPITAL ---> Ozamis City, Misamis Occidental ---> ph
W.G. CORTEZ MEDICAL AND ---> Tabang, Plaridel, Bulacan ---> ph
WESLEYAN UNIVERSITY PHILIPPINES ---> HOSPITAL ---> ph
WEST MINDORO POLYCLINIC, INC. ---> Sta. Maria, Bulacan ---> ph
WEST VISAYAS STATE ---> (formerly Pamana Medical Center) ---> ph
WESTERN KALINGA ---> Sto. Entierro St., Angeles City ---> ph
WESTERN LEYTE ---> Cardinal Santos St., Sto. Nino ---> ph
WESTERN MINDANAO MEDICAL CENTER ---> Guagua, Pampanga ---> ph
WESTERN PANGASINAN ---> HOSPITAL, INC. ---> ph
WESTERN VISAYAS SANITARIUM ---> Kamague, Iligan City ---> ph
WILFREDO C. PALMA MEMORIAL ---> Palanas, Lemery, Batangas ---> ph
WORD OF HOPE GENERAL ---> J.P. Laurel Highway ---> ph
WORLD CITI MEDICAL CENTER ---> Marawoy, Lipa City ---> ph
XU COMMUNITY HOSPITAL ---> V. Sagun St., Lumbia Dist. ---> ph
YUMENA HOSPITAL ---> Pagadian City, ---> ph
YNARES MUNICIPAL HOSPITAL ---> Zamboanga Del Sur ---> ph
ZMK DOCTORS CLINIC AND ---> San Roque, Cainta, Rizal ---> ph
ZAEC COMMUNITY MEDICAL ---> Molino IV, Bacoor, Cavite ---> ph
ZAFRA MEDICAL CLINIC ---> Roxas Dike (Bantay) ---> ph
ZAMBOANGA CHILDREN'S ---> Vigan,Ilocos Sur ---> ph
ZAMBOANGA CITY MEDICAL CENTER ---> CENTER-NASUGBU BRANCH ---> ph
ZAMBOANGA DEL NORTE ---> Km. 72 Brgy. Kaylaway Sitio ---> ph
ZAMBOANGA DEL NORTE ---> Batulao, Nasugbu, Batangas ---> ph
ZAMBOANGA DEL SUR ---> (formerly Metropolitan Hospital) ---> ph
ZAMBOANGA DOCTOR'S HOSPITAL, INC. ---> 1357 G. Masangkay St. ---> ph
ZAMBOANGA PUERICULTURE ---> Tondo, Manila ---> ph
ZAMBOANGA SIBUGAY PROVINCIAL ---> HOSPITAL INC. ---> ph
ZAPANTA GENERAL HOSPITAL ---> Banga, Meycauayan, Bulacan ---> ph
ZAPANTA MATERNITY & ---> Midsalip, Zamboanga Del Sur ---> ph
ZARATAN-JIMENEZ MED. CLINIC ---> DOCTOR'S HOSPITAL ---> ph
ZARSONA MEDICAL CLINIC ---> Midsayap, North Cotabato ---> ph
ZENON T. LAGUMBAY ---> CENTER AND HOSPITAL ---> ph
ZIGA MEMORIAL DISTRICT ---> Pob. 8 Quezon Ave. ---> ph
ZIGZAG HOSPITAL ---> Midsayap, North Cotabato ---> ph
